Type,Product,Started Date,Completed Date,Description,Amount,Fee,Currency,State,Balance
TRANSFER,Current,2022-04-06 07:05:16,2022-04-06 07:05:16,To GBP Rainy day,-5.00,0.00,GBP,COMPLETED,12553.42
TRANSFER,Current,2022-04-06 09:48:28,2022-04-06 09:48:28,To GBP Rainy day,-2.10,0.00,GBP,COMPLETED,12551.32
CARD_PAYMENT,Current,2022-04-05 13:31:18,2022-04-06 09:49:57,Nando's,-16.25,0.00,GBP,COMPLETED,12535.07
TRANSFER,Current,2022-04-06 11:24:18,2022-04-06 11:24:18,To GBP Rainy day,-1.95,0.00,GBP,COMPLETED,12533.12
CARD_PAYMENT,Current,2022-04-05 09:29:39,2022-04-06 12:33:19,Starbucks,-3.35,0.00,GBP,COMPLETED,12529.77
CARD_PAYMENT,Current,2022-04-05 10:40:34,2022-04-06 12:33:19,Starbucks,-3.35,0.00,GBP,COMPLETED,12526.42
CARD_PAYMENT,Current,2022-04-05 18:30:29,2022-04-06 13:18:44,Riverside Supermarket,-1.60,0.00,GBP,COMPLETED,12524.82
TRANSFER,Current,2022-04-06 15:02:47,2022-04-06 15:02:47,To GBP Rainy day,-1.65,0.00,GBP,COMPLETED,12523.17
TRANSFER,Current,2022-04-06 18:44:41,2022-04-06 18:44:41,To GBP Rainy day,-0.30,0.00,GBP,COMPLETED,12522.87
TRANSFER,Current,2022-04-06 18:51:58,2022-04-06 18:51:58,To GBP Rainy day,-2.70,0.00,GBP,COMPLETED,12520.17
TRANSFER,Current,2022-04-07 01:40:18,2022-04-07 01:40:18,To GBP Rainy day,-0.60,0.00,GBP,COMPLETED,12519.57
TRANSFER,Current,2022-04-07 07:06:08,2022-04-07 07:06:08,To GBP Rainy day,-5.00,0.00,GBP,COMPLETED,12514.57
TRANSFER,Current,2022-04-07 09:39:48,2022-04-07 09:39:48,To GBP Rainy day,-1.95,0.00,GBP,COMPLETED,12512.62
TRANSFER,Current,2022-04-07 11:09:32,2022-04-07 11:09:32,To GBP Rainy day,-1.95,0.00,GBP,COMPLETED,12510.67
TRANSFER,Current,2022-04-07 13:19:52,2022-04-07 13:19:52,To GBP Rainy day,-0.03,0.00,GBP,COMPLETED,12510.64
CARD_PAYMENT,Current,2022-04-05 18:02:53,2022-04-07 14:16:33,No 35 Mackenzie Walk,-7.00,0.00,GBP,COMPLETED,12503.64
CARD_PAYMENT,Current,2022-04-06 09:48:28,2022-04-07 14:43:52,Starbucks,-3.30,0.00,GBP,COMPLETED,12500.34
CARD_PAYMENT,Current,2022-04-06 11:24:18,2022-04-07 14:43:52,Starbucks,-3.35,0.00,GBP,COMPLETED,12496.99
CARD_PAYMENT,Current,2022-04-06 18:51:58,2022-04-07 14:58:44,Wasabi Sushi & Bento,-25.10,0.00,GBP,COMPLETED,12471.89
CARD_PAYMENT,Current,2022-04-06 15:02:47,2022-04-07 15:01:13,Waitrose & Partners,-18.45,0.00,GBP,COMPLETED,12453.44
CARD_PAYMENT,Current,2022-04-06 18:44:41,2022-04-07 15:01:14,Waitrose & Partners,-10.90,0.00,GBP,COMPLETED,12442.54
CARD_PAYMENT,Current,2022-04-07 01:40:17,2022-04-07 16:23:57,Transport for London,-1.80,0.00,GBP,COMPLETED,12440.74
TRANSFER,Current,2022-04-07 18:07:53,2022-04-07 18:07:53,To GBP Rainy day,-1.65,0.00,GBP,COMPLETED,12439.09
TRANSFER,Current,2022-04-07 18:16:11,2022-04-07 18:16:11,To GBP Rainy day,-3.00,0.00,GBP,COMPLETED,12436.09
TRANSFER,Current,2022-04-07 18:43:56,2022-04-07 18:43:56,To GBP Rainy day,-3.00,0.00,GBP,COMPLETED,12433.09
TRANSFER,Current,2022-04-08 07:08:08,2022-04-08 07:08:08,To GBP Rainy day,-5.00,0.00,GBP,COMPLETED,12428.09
TRANSFER,Current,2022-04-08 09:34:24,2022-04-08 09:34:24,To GBP Rainy day,-1.95,0.00,GBP,COMPLETED,12426.14
TRANSFER,Current,2022-04-08 10:42:27,2022-04-08 10:42:27,To GBP Rainy day,-1.95,0.00,GBP,COMPLETED,12424.19
CARD_PAYMENT,Current,2022-04-07 09:39:48,2022-04-08 11:06:21,Starbucks,-3.35,0.00,GBP,COMPLETED,12420.84
CARD_PAYMENT,Current,2022-04-07 11:09:32,2022-04-08 11:06:21,Starbucks,-3.35,0.00,GBP,COMPLETED,12417.49
CARD_PAYMENT,Current,2022-04-07 18:07:52,2022-04-08 13:06:46,Waitrose & Partners,-40.45,0.00,GBP,COMPLETED,12377.04
TRANSFER,Current,2022-04-08 13:13:59,2022-04-08 13:13:59,To GBP Rainy day,-3.00,0.00,GBP,COMPLETED,12374.04
CARD_PAYMENT,Current,2022-04-07 18:43:55,2022-04-08 13:25:54,Riverside Supermarket,-46.00,0.00,GBP,COMPLETED,12328.04
CARD_PAYMENT,Current,2022-04-07 13:19:52,2022-04-08 18:07:55,Apple,-9.99,0.00,GBP,COMPLETED,12318.05
TRANSFER,Current,2022-04-08 18:54:51,2022-04-08 18:54:51,To GBP Rainy day,-1.50,0.00,GBP,COMPLETED,12316.55
TRANSFER,Current,2022-04-09 07:05:18,2022-04-09 07:05:18,To GBP Rainy day,-5.00,0.00,GBP,COMPLETED,12311.55
CARD_PAYMENT,Current,2022-04-08 10:42:26,2022-04-09 12:23:29,Starbucks,-3.35,0.00,GBP,COMPLETED,12308.20
CARD_PAYMENT,Current,2022-04-08 09:34:24,2022-04-09 12:23:30,Starbucks,-3.35,0.00,GBP,COMPLETED,12304.85
CARD_PAYMENT,Current,2022-04-08 18:16:45,2022-04-09 15:20:52,Waitrose & Partners,-32.44,0.00,GBP,COMPLETED,12272.41
CARD_PAYMENT,Current,2022-04-08 18:54:51,2022-04-09 15:42:06,Riverside Supermarket,-16.50,0.00,GBP,COMPLETED,12255.91
CARD_PAYMENT,Current,2022-04-08 13:13:59,2022-04-09 16:14:16,Marugame Udon,-7.00,0.00,GBP,COMPLETED,12248.91
TRANSFER,Current,2022-04-09 19:41:03,2022-04-09 19:41:03,To GBP Rainy day,-3.00,0.00,GBP,COMPLETED,12245.91
TRANSFER,Current,2022-04-10 01:37:42,2022-04-10 01:37:42,To GBP Rainy day,-1.20,0.00,GBP,COMPLETED,12244.71
TRANSFER,Current,2022-04-10 07:06:22,2022-04-10 07:06:22,To GBP Rainy day,-5.00,0.00,GBP,COMPLETED,12239.71
TRANSFER,Current,2022-04-10 12:13:16,2022-04-10 12:13:16,To GBP Rainy day,-1.59,0.00,GBP,COMPLETED,12238.12
CARD_PAYMENT,Current,2022-04-09 19:41:03,2022-04-10 12:56:47,Waitrose & Partners,-54.00,0.00,GBP,COMPLETED,12184.12
CARD_PAYMENT,Current,2022-04-09 22:27:48,2022-04-10 13:08:09,EE,-25.00,0.00,GBP,COMPLETED,12159.12
CARD_PAYMENT,Current,2022-04-08 18:28:53,2022-04-10 13:12:49,No 35 Mackenzie Walk,-7.00,0.00,GBP,COMPLETED,12152.12
CARD_PAYMENT,Current,2022-04-07 18:16:11,2022-04-10 13:12:49,No 35 Mackenzie Walk,-7.00,0.00,GBP,COMPLETED,12145.12
CARD_PAYMENT,Current,2022-04-10 01:37:42,2022-04-10 14:33:49,Transport for London,-1.60,0.00,GBP,COMPLETED,12143.52
CARD_PAYMENT,Current,2022-04-10 19:21:40,,Hi Tec Washrooms S,-0.50,0.00,GBP,REVERTED,
TRANSFER,Current,2022-04-10 19:21:40,2022-04-10 19:21:40,To GBP Rainy day,-1.50,0.00,GBP,COMPLETED,12142.02
TRANSFER,Current,2022-04-10 19:21:55,2022-04-10 19:21:55,To GBP Rainy day,-1.50,0.00,GBP,COMPLETED,12140.52
TRANSFER,Current,2022-04-10 19:33:32,2022-04-10 19:33:32,To GBP Rainy day,-2.40,0.00,GBP,COMPLETED,12138.12
TRANSFER,Current,2022-04-10 19:57:09,2022-04-10 19:57:09,To GBP Rainy day,-2.40,0.00,GBP,COMPLETED,12135.72
TRANSFER,Current,2022-04-10 20:53:26,2022-04-10 20:53:26,To GBP Rainy day,-2.70,0.00,GBP,COMPLETED,12133.02
TRANSFER,Current,2022-04-11 01:21:21,2022-04-11 01:21:21,To GBP Rainy day,-2.40,0.00,GBP,COMPLETED,12130.62
TRANSFER,Current,2022-04-11 07:25:24,2022-04-11 07:25:24,To GBP Rainy day,-5.00,0.00,GBP,COMPLETED,12125.62
TRANSFER,Current,2022-04-11 09:21:02,2022-04-11 09:21:02,To GBP Rainy day,-1.95,0.00,GBP,COMPLETED,12123.67
CARD_PAYMENT,Current,2022-04-10 19:33:32,2022-04-11 10:00:52,Eventim Apollo,-21.20,0.00,GBP,COMPLETED,12102.47
CARD_PAYMENT,Current,2022-04-10 20:37:02,2022-04-11 10:02:12,Eventim Apollo,-18.20,0.00,GBP,COMPLETED,12084.27
CARD_PAYMENT,Current,2022-04-10 20:56:00,2022-04-11 10:02:12,Eventim Apollo,-9.10,0.00,GBP,COMPLETED,12075.17
CARD_PAYMENT,Current,2022-04-10 22:05:10,2022-04-11 10:02:12,Eventim Apollo,-11.10,0.00,GBP,COMPLETED,12064.07
CARD_PAYMENT,Current,2022-04-10 20:53:26,2022-04-11 10:14:54,Eventim Apollo,-2.10,0.00,GBP,COMPLETED,12061.97
CARD_PAYMENT,Current,2022-04-10 19:57:09,2022-04-11 10:14:54,Eventim Apollo,-18.20,0.00,GBP,COMPLETED,12043.77
TRANSFER,Current,2022-04-11 12:08:20,2022-04-11 12:08:20,To GBP Rainy day,-0.03,0.00,GBP,COMPLETED,12043.74
TRANSFER,Current,2022-04-11 12:59:20,2022-04-11 12:59:20,To GBP Rainy day,-1.68,0.00,GBP,COMPLETED,12042.06
TRANSFER,Current,2022-04-11 13:03:37,2022-04-11 13:03:37,To GBP Rainy day,-3.00,0.00,GBP,COMPLETED,12039.06
CARD_PAYMENT,Current,2022-04-11 01:21:21,2022-04-11 16:16:21,Transport for London,-5.20,0.00,GBP,COMPLETED,12033.86
CARD_PAYMENT,Current,2022-04-10 19:21:54,2022-04-11 16:53:16,Hi Tec Washrooms S,-0.50,0.00,GBP,COMPLETED,12033.36
TRANSFER,Current,2022-04-11 20:34:38,2022-04-11 20:34:38,To GBP Rainy day,-3.00,0.00,GBP,COMPLETED,12030.36
TRANSFER,Current,2022-04-12 01:05:15,2022-04-12 01:05:15,To GBP Rainy day,-2.40,0.00,GBP,COMPLETED,12027.96
TRANSFER,Current,2022-04-12 01:08:16,2022-04-12 01:08:16,To GBP Rainy day,-2.70,0.00,GBP,COMPLETED,12025.26
TRANSFER,Current,2022-04-12 01:16:57,2022-04-12 01:16:57,To GBP Rainy day,-2.70,0.00,GBP,COMPLETED,12022.56
TRANSFER,Current,2022-04-12 01:00:00,2022-04-12 01:24:29,To Billing Better,-210.03,0.00,GBP,COMPLETED,11812.53
TRANSFER,Current,2022-04-12 01:39:46,2022-04-12 01:39:46,To GBP Rainy day,-2.22,0.00,GBP,COMPLETED,11810.31
TRANSFER,Current,2022-04-12 03:34:17,2022-04-12 03:34:17,To GBP Rainy day,-1.50,0.00,GBP,COMPLETED,11808.81
TRANSFER,Current,2022-04-12 07:05:03,2022-04-12 07:05:03,To GBP Rainy day,-5.00,0.00,GBP,COMPLETED,11803.81
TRANSFER,Current,2022-04-12 10:17:05,2022-04-12 10:17:05,To GBP Rainy day,-1.95,0.00,GBP,COMPLETED,11801.86
CARD_PAYMENT,Current,2022-04-10 12:13:16,2022-04-12 11:15:41,Amazon,-242.47,0.00,GBP,COMPLETED,11559.39
TRANSFER,Current,2022-04-12 11:27:45,2022-04-12 11:27:45,To GBP Rainy day,-1.95,0.00,GBP,COMPLETED,11557.44
CARD_PAYMENT,Current,2022-04-11 09:21:02,2022-04-12 14:18:14,Starbucks,-3.35,0.00,GBP,COMPLETED,11554.09
CARD_PAYMENT,Current,2022-04-11 04:43:40,2022-04-12 16:05:47,Waitrose,-192.26,0.00,GBP,COMPLETED,11361.83
CARD_PAYMENT,Current,2022-04-11 12:33:37,2022-04-12 16:24:33,Marugame Udon,-11.50,0.00,GBP,COMPLETED,11350.33
TRANSFER,Current,2022-04-12 17:56:22,2022-04-12 17:56:22,To GBP Rainy day,-1.05,0.00,GBP,COMPLETED,11349.28
TRANSFER,Current,2022-04-12 18:23:44,2022-04-12 18:23:44,To GBP Rainy day,-1.80,0.00,GBP,COMPLETED,11347.48
CARD_PAYMENT,Current,2022-04-11 12:08:20,2022-04-12 19:13:51,Apple,-4.99,0.00,GBP,COMPLETED,11342.49
TRANSFER,Current,2022-04-13 07:05:05,2022-04-13 07:05:05,To GBP Rainy day,-5.00,0.00,GBP,COMPLETED,11337.49
TRANSFER,Current,2022-04-13 09:56:16,2022-04-13 09:56:16,To GBP Rainy day,-1.95,0.00,GBP,COMPLETED,11335.54
CARD_PAYMENT,Current,2022-04-12 10:17:05,2022-04-13 11:45:48,Starbucks,-3.35,0.00,GBP,COMPLETED,11332.19
CARD_PAYMENT,Current,2022-04-12 11:27:41,2022-04-13 11:45:48,Starbucks,-3.35,0.00,GBP,COMPLETED,11328.84
CARD_PAYMENT,Current,2022-04-12 17:56:21,2022-04-13 12:07:55,Waitrose & Partners,-46.65,0.00,GBP,COMPLETED,11282.19
CARD_PAYMENT,Current,2022-04-12 18:23:44,2022-04-13 12:35:44,Riverside Supermarket,-44.40,0.00,GBP,COMPLETED,11237.79
TRANSFER,Current,2022-04-13 13:26:34,2022-04-13 13:26:34,To GBP Rainy day,-1.95,0.00,GBP,COMPLETED,11235.84
EXCHANGE,Current,2022-04-13 13:48:52,2022-04-13 13:48:52,Exchanged to GBP,1988.54,0.00,GBP,COMPLETED,13224.38
TRANSFER,Current,2022-04-13 14:55:04,2022-04-13 14:55:04,To GBP Rainy day,-1.68,0.00,GBP,COMPLETED,13222.70
TRANSFER,Current,2022-04-13 17:32:05,2022-04-13 17:32:05,To GBP Rainy day,-2.43,0.00,GBP,COMPLETED,13220.27
TRANSFER,Current,2022-04-13 17:40:10,2022-04-13 17:40:10,To GBP Rainy day,-3.00,0.00,GBP,COMPLETED,13217.27
TRANSFER,Current,2022-04-13 21:35:56,2022-04-13 21:35:56,To GBP Rainy day,-1.95,0.00,GBP,COMPLETED,13215.32
TRANSFER,Current,2022-04-13 21:55:50,2022-04-13 21:55:50,To GBP Rainy day,-2.85,0.00,GBP,COMPLETED,13212.47
TRANSFER,Current,2022-04-14 07:05:58,2022-04-14 07:05:58,To GBP Rainy day,-5.00,0.00,GBP,COMPLETED,13207.47
TRANSFER,Current,2022-04-14 09:30:45,2022-04-14 09:30:45,To GBP Rainy day,-1.95,0.00,GBP,COMPLETED,13205.52
CARD_PAYMENT,Current,2022-04-13 13:26:34,2022-04-14 10:31:35,Starbucks,-3.35,0.00,GBP,COMPLETED,13202.17
CARD_PAYMENT,Current,2022-04-13 09:56:16,2022-04-14 10:31:35,Starbucks,-3.35,0.00,GBP,COMPLETED,13198.82
CARD_PAYMENT,Current,2022-04-13 17:32:04,2022-04-14 10:46:01,Waitrose & Partners,-26.19,0.00,GBP,COMPLETED,13172.63
TRANSFER,Current,2022-04-14 11:03:30,2022-04-14 11:03:30,To GBP Rainy day,-0.45,0.00,GBP,COMPLETED,13172.18
TRANSFER,Current,2022-04-14 12:02:14,2022-04-14 12:02:14,To GBP Rainy day,-3.00,0.00,GBP,COMPLETED,13169.18
CARD_PAYMENT,Current,2022-04-13 14:55:03,2022-04-14 12:02:30,Co-op,-25.44,0.00,GBP,COMPLETED,13143.74
CARD_PAYMENT,Current,2022-04-13 21:55:50,2022-04-14 12:03:35,Sainsbury's,-9.05,0.00,GBP,COMPLETED,13134.69
CARD_PAYMENT,Current,2022-04-13 21:35:56,2022-04-14 12:03:35,Sainsbury's,-14.35,0.00,GBP,COMPLETED,13120.34
TRANSFER,Current,2022-04-14 12:27:03,2022-04-14 12:27:03,From Mansur Kurmakaev,30.00,0.00,GBP,COMPLETED,13150.34
TRANSFER,Current,2022-04-14 14:09:35,2022-04-14 14:09:35,To GBP Rainy day,-3.00,0.00,GBP,COMPLETED,13147.34
TRANSFER,Current,2022-04-14 17:38:11,2022-04-14 17:38:11,To GBP Rainy day,-1.80,0.00,GBP,COMPLETED,13145.54
TRANSFER,Current,2022-04-15 07:08:43,2022-04-15 07:08:43,To GBP Rainy day,-5.00,0.00,GBP,COMPLETED,13140.54
CARD_PAYMENT,Current,2022-04-13 17:40:09,2022-04-15 13:08:17,No 35 Mackenzie Walk,-7.00,0.00,GBP,COMPLETED,13133.54
CARD_PAYMENT,Current,2022-04-14 14:09:35,2022-04-15 13:37:07,Adam Grooming Atelier,-30.00,0.00,GBP,COMPLETED,13103.54
CARD_PAYMENT,Current,2022-04-14 11:03:30,2022-04-15 13:42:43,Starbucks,-3.85,0.00,GBP,COMPLETED,13099.69
CARD_PAYMENT,Current,2022-04-14 09:30:45,2022-04-15 13:42:44,Starbucks,-3.35,0.00,GBP,COMPLETED,13096.34
TRANSFER,Current,2022-04-15 14:00:26,2022-04-15 14:00:26,To GBP Rainy day,-1.50,0.00,GBP,COMPLETED,13094.84
TRANSFER,Current,2022-04-15 14:23:37,2022-04-15 14:23:37,To GBP Rainy day,-2.40,0.00,GBP,COMPLETED,13092.44
TRANSFER,Current,2022-04-15 16:10:40,2022-04-15 16:10:40,To GBP Rainy day,-3.00,0.00,GBP,COMPLETED,13089.44
CARD_PAYMENT,Current,2022-04-14 17:38:11,2022-04-15 16:11:50,Hazev Ltd T/a Hazev Caf,-14.40,0.00,GBP,COMPLETED,13075.04
CARD_PAYMENT,Current,2022-04-14 12:02:14,2022-04-15 17:34:03,Marugame Udon,-16.00,0.00,GBP,COMPLETED,13059.04
TRANSFER,Current,2022-04-15 17:41:08,2022-04-15 17:41:08,To GBP Rainy day,-3.00,0.00,GBP,COMPLETED,13056.04
TRANSFER,Current,2022-04-15 19:04:24,2022-04-15 19:04:24,To GBP Rainy day,-1.65,0.00,GBP,COMPLETED,13054.39
TRANSFER,Current,2022-04-15 19:18:45,2022-04-15 19:18:45,To GBP Rainy day,-1.50,0.00,GBP,COMPLETED,13052.89
TRANSFER,Current,2022-04-16 07:05:28,2022-04-16 07:05:28,To GBP Rainy day,-5.00,0.00,GBP,COMPLETED,13047.89
CARD_PAYMENT,Current,2022-04-15 14:00:25,2022-04-16 10:36:05,The Royal Society,-27.50,0.00,GBP,COMPLETED,13020.39
CARD_PAYMENT,Current,2022-04-15 19:04:24,2022-04-16 10:43:20,The Royal Society,-42.45,0.00,GBP,COMPLETED,12977.94
TRANSFER,Current,2022-04-16 11:56:08,2022-04-16 11:56:08,To GBP Rainy day,-1.38,0.00,GBP,COMPLETED,12976.56
CARD_PAYMENT,Current,2022-04-15 16:10:40,2022-04-16 12:05:01,The Pier Dry End,-4.00,0.00,GBP,COMPLETED,12972.56
CARD_PAYMENT,Current,2022-04-15 17:41:07,2022-04-16 12:37:05,c2c,-24.00,0.00,GBP,COMPLETED,12948.56
CARD_PAYMENT,Current,2022-04-15 14:23:37,2022-04-16 12:37:06,c2c,-24.20,0.00,GBP,COMPLETED,12924.36
TRANSFER,Current,2022-04-16 13:19:04,2022-04-16 13:19:04,To GBP Rainy day,-1.86,0.00,GBP,COMPLETED,12922.50
TRANSFER,Current,2022-04-16 13:24:26,2022-04-16 13:24:26,To GBP Rainy day,-0.03,0.00,GBP,COMPLETED,12922.47
TRANSFER,Current,2022-04-16 13:25:44,2022-04-16 13:25:44,To GBP Rainy day,-0.90,0.00,GBP,COMPLETED,12921.57
CARD_PAYMENT,Current,2022-04-15 19:18:45,2022-04-16 13:28:31,The Royal Foundation,-4.50,0.00,GBP,COMPLETED,12917.07
TRANSFER,Current,2022-04-16 15:13:38,2022-04-16 15:13:38,To GBP Rainy day,-2.73,0.00,GBP,COMPLETED,12914.34
TRANSFER,Current,2022-04-16 17:28:33,2022-04-16 17:28:33,To GBP Rainy day,-0.60,0.00,GBP,COMPLETED,12913.74
TRANSFER,Current,2022-04-16 17:39:20,2022-04-16 17:39:20,To GBP Rainy day,-3.00,0.00,GBP,COMPLETED,12910.74
TRANSFER,Current,2022-04-17 01:30:39,2022-04-17 01:30:39,To GBP Rainy day,-0.90,0.00,GBP,COMPLETED,12909.84
TRANSFER,Current,2022-04-17 07:05:15,2022-04-17 07:05:15,To GBP Rainy day,-5.00,0.00,GBP,COMPLETED,12904.84
CARD_PAYMENT,Current,2022-04-16 11:56:08,2022-04-17 09:23:18,Amazon,-48.54,0.00,GBP,COMPLETED,12856.30
CARD_PAYMENT,Current,2022-04-16 13:24:26,2022-04-17 10:11:57,Boots,-6.99,0.00,GBP,COMPLETED,12849.31
CARD_PAYMENT,Current,2022-04-16 13:25:44,2022-04-17 10:14:15,Boots,-0.70,0.00,GBP,COMPLETED,12848.61
CARD_PAYMENT,Current,2022-04-16 17:28:33,2022-04-17 11:16:04,Waitrose & Partners,-41.80,0.00,GBP,COMPLETED,12806.81
CARD_PAYMENT,Current,2022-04-17 01:30:39,2022-04-17 12:43:19,Transport for London,-7.70,0.00,GBP,COMPLETED,12799.11
CARD_PAYMENT,Current,2022-04-16 15:13:37,2022-04-17 12:43:19,Riding House Cafe,-41.09,0.00,GBP,COMPLETED,12758.02
CARD_PAYMENT,Current,2022-04-16 13:19:04,2022-04-17 12:44:36,Holland & Barrett,-21.38,0.00,GBP,COMPLETED,12736.64
TRANSFER,Current,2022-04-17 13:29:33,2022-04-17 13:29:33,To GBP Rainy day,-1.20,0.00,GBP,COMPLETED,12735.44
TRANSFER,Current,2022-04-17 15:29:40,2022-04-17 15:29:40,To GBP Rainy day,-3.00,0.00,GBP,COMPLETED,12732.44
TRANSFER,Current,2022-04-17 15:37:34,2022-04-17 15:37:34,To GBP Rainy day,-0.90,0.00,GBP,COMPLETED,12731.54
TRANSFER,Current,2022-04-17 18:53:52,2022-04-17 18:53:52,To GBP Rainy day,-3.00,0.00,GBP,COMPLETED,12728.54
TRANSFER,Current,2022-04-17 20:10:57,2022-04-17 20:10:57,To GBP Rainy day,-3.00,0.00,GBP,COMPLETED,12725.54
TRANSFER,Current,2022-04-17 20:17:14,2022-04-17 20:17:14,To GBP Rainy day,-1.50,0.00,GBP,COMPLETED,12724.04
TRANSFER,Current,2022-04-17 20:17:39,2022-04-17 20:17:39,To GBP Rainy day,-1.50,0.00,GBP,COMPLETED,12722.54
TRANSFER,Current,2022-04-17 23:34:51,2022-04-17 23:34:51,To GBP Rainy day,-0.03,0.00,GBP,COMPLETED,12722.51
TRANSFER,Current,2022-04-18 01:17:23,2022-04-18 01:17:23,To GBP Rainy day,-2.40,0.00,GBP,COMPLETED,12720.11
TRANSFER,Current,2022-04-18 07:21:02,2022-04-18 07:21:02,To GBP Rainy day,-5.00,0.00,GBP,COMPLETED,12715.11
CARD_PAYMENT,Current,2022-04-17 20:10:57,2022-04-18 10:21:28,Stagecoach,-1.00,0.00,GBP,COMPLETED,12714.11
CARD_PAYMENT,Current,2022-04-16 17:39:20,2022-04-18 10:33:30,No 35 Mackenzie Walk,-7.00,0.00,GBP,COMPLETED,12707.11
CARD_PAYMENT,Current,2022-04-17 13:29:33,2022-04-18 13:07:51,Riverside Supermarket,-29.60,0.00,GBP,COMPLETED,12677.51
CARD_PAYMENT,Current,2022-04-17 15:29:40,2022-04-18 13:25:44,TSGN,-43.00,0.00,GBP,COMPLETED,12634.51
CARD_PAYMENT,Current,2022-04-18 01:17:23,2022-04-18 13:32:54,Transport for London,-5.20,0.00,GBP,COMPLETED,12629.31
TRANSFER,Current,2022-04-18 13:51:42,2022-04-18 13:51:42,To GBP Rainy day,-0.93,0.00,GBP,COMPLETED,12628.38
TRANSFER,Current,2022-04-18 13:54:14,2022-04-18 13:54:14,To GBP Rainy day,-3.00,0.00,GBP,COMPLETED,12625.38
CARD_PAYMENT,Current,2022-04-17 18:53:51,2022-04-18 14:10:20,Foy Cafes,-30.00,0.00,GBP,COMPLETED,12595.38
CARD_PAYMENT,Current,2022-04-17 20:17:14,2022-04-18 14:16:22,Decorum Vending,-2.50,0.00,GBP,COMPLETED,12592.88
CARD_PAYMENT,Current,2022-04-17 20:17:39,2022-04-18 14:16:22,Decorum Vending,-2.50,0.00,GBP,COMPLETED,12590.38
TRANSFER,Current,2022-04-18 20:52:09,2022-04-18 20:52:09,To GBP Rainy day,-3.00,0.00,GBP,COMPLETED,12587.38
TRANSFER,Current,2022-04-18 22:09:09,2022-04-18 22:09:09,To GBP Rainy day,-2.07,0.00,GBP,COMPLETED,12585.31
TRANSFER,Current,2022-04-19 01:21:15,2022-04-19 01:21:15,To GBP Rainy day,-2.10,0.00,GBP,COMPLETED,12583.21
TRANSFER,Current,2022-04-19 07:04:52,2022-04-19 07:04:52,To GBP Rainy day,-5.00,0.00,GBP,COMPLETED,12578.21
TRANSFER,Current,2022-04-19 07:55:30,2022-04-19 07:55:30,To GBP Rainy day,-2.40,0.00,GBP,COMPLETED,12575.81
CARD_PAYMENT,Current,2022-04-17 23:34:50,2022-04-19 09:26:40,Amazon,-16.99,0.00,GBP,COMPLETED,12558.82
CARD_PAYMENT,Current,2022-04-18 22:09:09,2022-04-19 09:56:19,Lao Café,-97.31,0.00,GBP,COMPLETED,12461.51
TRANSFER,Current,2022-04-19 10:40:54,2022-04-19 10:40:54,To GBP Rainy day,-1.20,0.00,GBP,COMPLETED,12460.31
CARD_PAYMENT,Current,2022-04-17 15:37:34,2022-04-19 11:48:26,PAUL,-8.70,0.00,GBP,COMPLETED,12451.61
TRANSFER,Current,2022-04-19 12:11:40,2022-04-19 12:11:43,To Lingvo State Ltd,-250.00,0.00,GBP,COMPLETED,12201.61
CARD_PAYMENT,Current,2022-04-18 13:51:41,2022-04-19 12:14:37,Sainsbury's,-22.69,0.00,GBP,COMPLETED,12178.92
CARD_PAYMENT,Current,2022-04-18 13:54:14,2022-04-19 12:14:37,Sainsbury's,-10.00,0.00,GBP,COMPLETED,12168.92
CARD_PAYMENT,Current,2022-04-19 01:21:14,2022-04-19 12:14:37,Transport for London,-3.30,0.00,GBP,COMPLETED,12165.62
CARD_PAYMENT,Current,2022-04-18 20:52:08,2022-04-19 12:23:32,Lox Bar,-30.00,0.00,GBP,COMPLETED,12135.62
TRANSFER,Current,2022-04-19 13:43:19,2022-04-19 13:43:19,To GBP Rainy day,-2.55,0.00,GBP,COMPLETED,12133.07
TRANSFER,Current,2022-04-19 14:13:35,2022-04-19 14:13:36,From WECTORY LTD,79233.74,0.00,GBP,COMPLETED,91366.81
TRANSFER,Current,2022-04-19 14:16:47,2022-04-19 14:16:47,To GBP Education,-50000.00,0.00,GBP,COMPLETED,41366.81
TOPUP,Current,2022-04-19 14:17:19,2022-04-19 14:17:20,Payment from Mikhail Balabanov,10000.00,0.00,GBP,COMPLETED,51366.81
TRANSFER,Current,2022-04-19 14:18:18,2022-04-19 14:18:18,To GBP Savings,-48000.00,0.00,GBP,COMPLETED,3366.81
TRANSFER,Current,2022-04-19 16:16:01,2022-04-19 16:16:01,To GBP Rainy day,-3.00,0.00,GBP,COMPLETED,3363.81
TRANSFER,Current,2022-04-19 16:28:04,2022-04-19 16:28:04,To GBP Rainy day,-3.00,0.00,GBP,COMPLETED,3360.81
TRANSFER,Current,2022-04-19 16:43:02,2022-04-19 16:43:02,To GBP Rainy day,-2.40,0.00,GBP,COMPLETED,3358.41
TRANSFER,Current,2022-04-19 18:17:05,2022-04-19 18:17:05,To GBP Rainy day,-1.20,0.00,GBP,COMPLETED,3357.21
TRANSFER,Current,2022-04-19 20:02:44,2022-04-19 20:02:44,To GBP Rainy day,-2.25,0.00,GBP,COMPLETED,3354.96
TRANSFER,Current,2022-04-19 20:19:21,2022-04-19 20:19:21,To GBP Rainy day,-0.75,0.00,GBP,COMPLETED,3354.21
TRANSFER,Current,2022-04-19 22:56:16,2022-04-19 22:56:16,To GBP Rainy day,-3.00,0.00,GBP,COMPLETED,3351.21
TRANSFER,Current,2022-04-20 01:37:20,2022-04-20 01:37:20,To GBP Rainy day,-0.90,0.00,GBP,COMPLETED,3350.31
TRANSFER,Current,2022-04-20 07:05:25,2022-04-20 07:05:25,To GBP Rainy day,-5.00,0.00,GBP,COMPLETED,3345.31
EXCHANGE,Current,2022-04-20 07:48:12,2022-04-20 07:48:12,Exchanged to GBP,1303.83,0.00,GBP,COMPLETED,4649.14
TRANSFER,Current,2022-04-20 09:44:24,2022-04-20 09:44:24,To GBP Rainy day,-1.95,0.00,GBP,COMPLETED,4647.19
CARD_PAYMENT,Current,2022-04-19 16:28:03,2022-04-20 11:04:25,Boots,-20.00,0.00,GBP,COMPLETED,4627.19
CARD_PAYMENT,Current,2022-04-19 13:43:19,2022-04-20 11:57:14,Starbucks,-23.15,0.00,GBP,COMPLETED,4604.04
CARD_PAYMENT,Current,2022-04-19 10:40:54,2022-04-20 12:10:19,Starbucks,-3.60,0.00,GBP,COMPLETED,4600.44
TRANSFER,Current,2022-04-20 12:33:23,2022-04-20 12:33:23,To GBP Rainy day,-1.95,0.00,GBP,COMPLETED,4598.49
CARD_PAYMENT,Current,2022-04-19 16:43:02,2022-04-20 13:43:08,Waitrose & Partners,-30.20,0.00,GBP,COMPLETED,4568.29
CARD_PAYMENT,Current,2022-04-19 22:56:16,2022-04-20 13:54:38,EE,-27.00,0.00,GBP,COMPLETED,4541.29
CARD_PAYMENT,Current,2022-04-19 18:17:05,2022-04-20 13:57:07,Riverside Supermarket,-29.60,0.00,GBP,COMPLETED,4511.69
CARD_PAYMENT,Current,2022-04-19 16:16:01,2022-04-20 14:29:06,PAUL,-20.00,0.00,GBP,COMPLETED,4491.69
CARD_PAYMENT,Current,2022-04-19 20:02:44,2022-04-20 15:06:57,Honest Burgers,-39.25,0.00,GBP,COMPLETED,4452.44
CARD_PAYMENT,Current,2022-04-19 20:19:20,2022-04-20 15:06:57,Honest Burgers,-5.75,0.00,GBP,COMPLETED,4446.69
CARD_PAYMENT,Current,2022-04-20 01:37:20,2022-04-20 15:19:12,Transport for London,-7.70,0.00,GBP,COMPLETED,4438.99
TRANSFER,Current,2022-04-20 18:05:23,2022-04-20 18:05:23,To GBP Rainy day,-0.66,0.00,GBP,COMPLETED,4438.33
TRANSFER,Current,2022-04-20 21:34:32,2022-04-20 21:34:32,To GBP Rainy day,-0.63,0.00,GBP,COMPLETED,4437.70
TRANSFER,Current,2022-04-21 01:42:27,2022-04-21 01:42:27,To GBP Rainy day,-0.60,0.00,GBP,COMPLETED,4437.10
TRANSFER,Current,2022-04-21 07:06:03,2022-04-21 07:06:03,To GBP Rainy day,-5.00,0.00,GBP,COMPLETED,4432.10
CARD_PAYMENT,Current,2022-04-19 07:55:29,2022-04-21 10:07:13,Global E.crossrope,-127.20,0.00,GBP,COMPLETED,4304.90
CARD_PAYMENT,Current,2022-04-20 09:44:24,2022-04-21 10:53:21,Starbucks,-3.35,0.00,GBP,COMPLETED,4301.55
CARD_PAYMENT,Current,2022-04-20 12:33:23,2022-04-21 10:54:59,Starbucks,-3.35,0.00,GBP,COMPLETED,4298.20
CARD_PAYMENT,Current,2022-04-20 18:05:23,2022-04-21 11:13:03,Waitrose & Partners,-39.78,0.00,GBP,COMPLETED,4258.42
TRANSFER,Current,2022-04-21 11:22:02,2022-04-21 11:22:02,To GBP Rainy day,-1.95,0.00,GBP,COMPLETED,4256.47
CARD_PAYMENT,Current,2022-04-21 01:42:26,2022-04-21 12:56:43,Transport for London,-5.80,0.00,GBP,COMPLETED,4250.67
CARD_PAYMENT,Current,2022-04-20 21:34:32,2022-04-21 15:14:46,Apple,-1.79,0.00,GBP,COMPLETED,4248.88
TRANSFER,Current,2022-04-21 17:31:56,2022-04-21 17:31:56,To GBP Rainy day,-2.67,0.00,GBP,COMPLETED,4246.21
TRANSFER,Current,2022-04-21 17:36:01,2022-04-21 17:36:01,To GBP Rainy day,-3.00,0.00,GBP,COMPLETED,4243.21
TRANSFER,Current,2022-04-21 17:49:39,2022-04-21 17:49:39,To GBP Rainy day,-3.00,0.00,GBP,COMPLETED,4240.21
TRANSFER,Current,2022-04-21 19:37:50,2022-04-21 19:37:50,To GBP Rainy day,-2.64,0.00,GBP,COMPLETED,4237.57
TRANSFER,Current,2022-04-22 01:41:15,2022-04-22 01:41:15,To GBP Rainy day,-0.15,0.00,GBP,COMPLETED,4237.42
TRANSFER,Current,2022-04-22 03:18:09,2022-04-22 03:18:09,To GBP Rainy day,-0.03,0.00,GBP,COMPLETED,4237.39
TRANSFER,Current,2022-04-22 07:08:01,2022-04-22 07:08:01,To GBP Rainy day,-5.00,0.00,GBP,COMPLETED,4232.39
TRANSFER,Current,2022-04-22 10:02:40,2022-04-22 10:02:40,To GBP Rainy day,-1.95,0.00,GBP,COMPLETED,4230.44
TRANSFER,Current,2022-04-22 11:40:03,2022-04-22 11:40:03,To GBP Rainy day,-1.65,0.00,GBP,COMPLETED,4228.79
CARD_PAYMENT,Current,2022-04-21 17:36:01,2022-04-22 11:45:58,Petersham Nurseries Delicatessen and Cellar,-19.00,0.00,GBP,COMPLETED,4209.79
CARD_PAYMENT,Current,2022-04-21 17:49:38,2022-04-22 11:45:58,Petersham Nurseries Delicatessen and Cellar,-19.00,0.00,GBP,COMPLETED,4190.79
TOPUP,Current,2022-04-22 12:37:06,2022-04-22 12:37:08,Payment from Henley   Partners Uk Ltd,7665.53,0.00,GBP,COMPLETED,11856.32
CARD_PAYMENT,Current,2022-04-21 19:37:49,2022-04-22 13:18:07,Thai Pot,-126.12,0.00,GBP,COMPLETED,11730.20
CARD_PAYMENT,Current,2022-04-21 17:31:56,2022-04-22 13:19:21,TK Maxx,-186.11,0.00,GBP,COMPLETED,11544.09
CARD_PAYMENT,Current,2022-04-21 11:22:02,2022-04-22 13:20:30,Starbucks,-3.35,0.00,GBP,COMPLETED,11540.74
TRANSFER,Current,2022-04-22 14:59:16,2022-04-22 14:59:16,To GBP Rainy day,-3.00,0.00,GBP,COMPLETED,11537.74
CARD_PAYMENT,Current,2022-04-22 01:41:15,2022-04-22 16:25:47,Transport for London,-11.95,0.00,GBP,COMPLETED,11525.79
TRANSFER,Current,2022-04-22 17:21:07,2022-04-22 17:21:07,To GBP Rainy day,-0.15,0.00,GBP,COMPLETED,11525.64
TRANSFER,Current,2022-04-22 17:24:07,2022-04-22 17:24:07,To GBP Rainy day,-1.53,0.00,GBP,COMPLETED,11524.11
TRANSFER,Current,2022-04-22 17:29:28,2022-04-22 17:29:28,To GBP Rainy day,-3.00,0.00,GBP,COMPLETED,11521.11
TRANSFER,Current,2022-04-22 18:02:03,2022-04-22 18:02:03,To GBP Rainy day,-1.80,0.00,GBP,COMPLETED,11519.31
TRANSFER,Current,2022-04-22 22:52:23,2022-04-22 22:52:23,To GBP Rainy day,-3.00,0.00,GBP,COMPLETED,11516.31
TRANSFER,Current,2022-04-23 07:05:16,2022-04-23 07:05:16,To GBP Rainy day,-5.00,0.00,GBP,COMPLETED,11511.31
CARD_PAYMENT,Current,2022-04-22 17:24:07,2022-04-23 09:59:15,Boots,-4.49,0.00,GBP,COMPLETED,11506.82
CARD_PAYMENT,Current,2022-04-22 10:02:40,2022-04-23 10:38:02,Starbucks,-3.35,0.00,GBP,COMPLETED,11503.47
CARD_PAYMENT,Current,2022-04-22 18:02:03,2022-04-23 11:09:09,Riverside Supermarket,-44.40,0.00,GBP,COMPLETED,11459.07
CARD_PAYMENT,Current,2022-04-22 22:52:23,2022-04-23 11:09:25,EE,-18.00,0.00,GBP,COMPLETED,11441.07
CARD_PAYMENT,Current,2022-04-22 17:29:27,2022-04-23 11:22:36,Flowers And Plants,-25.00,0.00,GBP,COMPLETED,11416.07
CARD_PAYMENT,Current,2022-04-22 11:40:02,2022-04-23 11:46:55,Marugame Udon,-13.45,0.00,GBP,COMPLETED,11402.62
CARD_PAYMENT,Current,2022-04-22 14:59:15,2022-04-23 12:02:45,Badiani,-6.00,0.00,GBP,COMPLETED,11396.62
CARD_PAYMENT,Current,2022-04-22 03:18:08,2022-04-23 16:16:47,Apple,-6.99,0.00,GBP,COMPLETED,11389.63
TRANSFER,Current,2022-04-23 16:33:35,2022-04-23 16:33:35,To GBP Rainy day,-1.53,0.00,GBP,COMPLETED,11388.10
TRANSFER,Current,2022-04-23 19:05:50,2022-04-23 19:05:50,To GBP Rainy day,-2.85,0.00,GBP,COMPLETED,11385.25
TRANSFER,Current,2022-04-23 19:25:19,2022-04-23 19:25:19,To GBP Rainy day,-2.10,0.00,GBP,COMPLETED,11383.15
TRANSFER,Current,2022-04-23 19:46:24,2022-04-23 19:46:24,To GBP Rainy day,-3.00,0.00,GBP,COMPLETED,11380.15
TRANSFER,Current,2022-04-23 20:27:31,2022-04-23 20:27:31,To GBP Rainy day,-0.09,0.00,GBP,COMPLETED,11380.06
TRANSFER,Current,2022-04-24 01:34:33,2022-04-24 01:34:33,To GBP Rainy day,-2.40,0.00,GBP,COMPLETED,11377.66
TRANSFER,Current,2022-04-24 07:05:14,2022-04-24 07:05:14,To GBP Rainy day,-5.00,0.00,GBP,COMPLETED,11372.66
CARD_PAYMENT,Current,2022-04-22 17:21:07,2022-04-24 09:38:10,Waitrose & Partners,-36.95,0.00,GBP,COMPLETED,11335.71
CARD_PAYMENT,Current,2022-04-23 20:27:31,2022-04-24 11:12:24,TK Maxx,-9.97,0.00,GBP,COMPLETED,11325.74
CARD_PAYMENT,Current,2022-04-23 19:25:19,2022-04-24 12:04:41,Rosa's Thai,-3.30,0.00,GBP,COMPLETED,11322.44
CARD_PAYMENT,Current,2022-04-23 19:46:23,2022-04-24 12:04:41,Rosa's Thai,-11.00,0.00,GBP,COMPLETED,11311.44
CARD_PAYMENT,Current,2022-04-23 16:33:35,2022-04-24 13:58:29,Apple,-2.49,0.00,GBP,COMPLETED,11308.95
TRANSFER,Current,2022-04-24 15:30:37,2022-04-24 15:30:37,To GBP Rainy day,-1.80,0.00,GBP,COMPLETED,11307.15
TRANSFER,Current,2022-04-24 15:52:46,2022-04-24 15:52:46,To GBP Rainy day,-0.15,0.00,GBP,COMPLETED,11307.00
TRANSFER,Current,2022-04-25 01:20:01,2022-04-25 01:20:01,To GBP Rainy day,-1.20,0.00,GBP,COMPLETED,11305.80
TRANSFER,Current,2022-04-25 07:21:32,2022-04-25 07:21:32,To GBP Rainy day,-5.00,0.00,GBP,COMPLETED,11300.80
TRANSFER,Current,2022-04-25 08:47:19,2022-04-25 08:47:19,To GBP Rainy day,-2.85,0.00,GBP,COMPLETED,11297.95
TRANSFER,Current,2022-04-25 08:48:22,2022-04-25 08:48:22,To GBP Rainy day,-1.95,0.00,GBP,COMPLETED,11296.00
TRANSFER,Current,2022-04-25 08:50:13,2022-04-25 08:50:13,To GBP Rainy day,-0.75,0.00,GBP,COMPLETED,11295.25
TRANSFER,Current,2022-04-25 08:54:35,2022-04-25 08:54:35,To GBP Rainy day,-1.95,0.00,GBP,COMPLETED,11293.30
CARD_PAYMENT,Current,2022-04-23 19:05:50,2022-04-25 09:49:29,Weekday,-125.05,0.00,GBP,COMPLETED,11168.25
CARD_PAYMENT,Current,2022-04-24 01:34:33,2022-04-25 10:08:24,Transport for London,-3.20,0.00,GBP,COMPLETED,11165.05
CARD_PAYMENT,Current,2022-04-24 15:30:37,2022-04-25 11:57:59,Waitrose & Partners,-106.40,0.00,GBP,COMPLETED,11058.65
TRANSFER,Current,2022-04-25 12:00:41,2022-04-25 12:00:41,To GBP Rainy day,-3.00,0.00,GBP,COMPLETED,11055.65
CARD_PAYMENT,Current,2022-04-24 15:52:46,2022-04-25 12:24:20,Grocery Station,-13.95,0.00,GBP,COMPLETED,11041.70
CARD_PAYMENT,Current,2022-04-25 01:20:01,2022-04-25 13:38:11,Transport for London,-1.60,0.00,GBP,COMPLETED,11040.10
TRANSFER,Current,2022-04-25 17:52:30,2022-04-25 17:52:30,To GBP Rainy day,-1.50,0.00,GBP,COMPLETED,11038.60
TRANSFER,Current,2022-04-25 17:55:04,2022-04-25 17:55:04,To GBP Rainy day,-0.03,0.00,GBP,COMPLETED,11038.57
TRANSFER,Current,2022-04-25 18:02:07,2022-04-25 18:02:07,To GBP Rainy day,-3.00,0.00,GBP,COMPLETED,11035.57
TRANSFER,Current,2022-04-25 18:12:43,2022-04-25 18:12:43,To GBP Rainy day,-3.00,0.00,GBP,COMPLETED,11032.57
TRANSFER,Current,2022-04-25 22:15:47,2022-04-25 22:15:47,To GBP Rainy day,-2.40,0.00,GBP,COMPLETED,11030.17
TRANSFER,Current,2022-04-26 01:34:42,2022-04-26 01:34:42,To GBP Rainy day,-2.40,0.00,GBP,COMPLETED,11027.77
TRANSFER,Current,2022-04-26 07:05:14,2022-04-26 07:05:14,To GBP Rainy day,-5.00,0.00,GBP,COMPLETED,11022.77
CARD_PAYMENT,Current,2022-04-25 17:55:04,2022-04-26 09:31:35,Boots,-6.99,0.00,GBP,COMPLETED,11015.78
CARD_PAYMENT,Current,2022-04-25 08:54:35,2022-04-26 09:59:22,Starbucks,-3.35,0.00,GBP,COMPLETED,11012.43
CARD_PAYMENT,Current,2022-04-25 17:52:30,2022-04-26 10:31:47,Waitrose & Partners,-33.50,0.00,GBP,COMPLETED,10978.93
TRANSFER,Current,2022-04-26 10:35:01,2022-04-26 10:35:01,To GBP Rainy day,-1.95,0.00,GBP,COMPLETED,10976.98
CARD_PAYMENT,Current,2022-04-25 08:50:13,2022-04-26 10:47:42,Canary Wharf,-4.75,0.00,GBP,COMPLETED,10972.23
CARD_PAYMENT,Current,2022-04-25 08:48:22,2022-04-26 11:00:57,PAUL,-4.35,0.00,GBP,COMPLETED,10967.88
CARD_PAYMENT,Current,2022-04-26 01:34:42,2022-04-26 11:27:36,Transport for London,-5.20,0.00,GBP,COMPLETED,10962.68
TRANSFER,Current,2022-04-26 12:36:35,2022-04-26 12:36:35,To GBP Rainy day,-1.95,0.00,GBP,COMPLETED,10960.73
TRANSFER,Current,2022-04-26 13:39:38,2022-04-26 13:39:38,To GBP Rainy day,-3.00,0.00,GBP,COMPLETED,10957.73
TRANSFER,Current,2022-04-26 20:44:02,2022-04-26 20:44:02,To GBP Rainy day,-1.65,0.00,GBP,COMPLETED,10956.08
TRANSFER,Current,2022-04-27 07:05:25,2022-04-27 07:05:25,To GBP Rainy day,-5.00,0.00,GBP,COMPLETED,10951.08
TRANSFER,Current,2022-04-27 07:52:13,2022-04-27 07:52:13,To GBP Savings,-2000.00,0.00,GBP,COMPLETED,8951.08
CARD_PAYMENT,Current,2022-04-26 20:44:02,2022-04-27 08:56:59,UPS,-76.45,0.00,GBP,COMPLETED,8874.63
CARD_PAYMENT,Current,2022-04-26 10:35:01,2022-04-27 09:16:04,Starbucks,-3.35,0.00,GBP,COMPLETED,8871.28
CARD_PAYMENT,Current,2022-04-26 12:36:35,2022-04-27 09:16:18,Starbucks,-3.35,0.00,GBP,COMPLETED,8867.93
CARD_PAYMENT,Current,2022-04-25 18:02:07,2022-04-27 09:44:42,No 35 Mackenzie Walk,-7.00,0.00,GBP,COMPLETED,8860.93
CARD_PAYMENT,Current,2022-04-25 18:12:43,2022-04-27 09:44:42,No 35 Mackenzie Walk,-7.00,0.00,GBP,COMPLETED,8853.93
CARD_PAYMENT,Current,2022-04-26 13:39:38,2022-04-27 09:52:31,Marugame Udon,-8.00,0.00,GBP,COMPLETED,8845.93
TRANSFER,Current,2022-04-27 10:19:03,2022-04-27 10:19:03,To GBP Rainy day,-1.95,0.00,GBP,COMPLETED,8843.98
CARD_PAYMENT,Current,2022-04-25 22:15:47,2022-04-27 11:47:04,Amazon,-7.20,0.00,GBP,COMPLETED,8836.78
CARD_PAYMENT,Current,2022-04-25 12:00:41,2022-04-27 11:47:58,Look mum no hands!,-3.00,0.00,GBP,COMPLETED,8833.78
CARD_PAYMENT,Current,2022-04-25 08:47:19,2022-04-27 11:49:40,Pret,-5.05,0.00,GBP,COMPLETED,8828.73
CARD_PAYMENT,Current,2022-04-26 01:00:00,2022-04-27 11:50:07,Amazon,-26.42,0.00,GBP,COMPLETED,8802.31
TRANSFER,Current,2022-04-27 11:50:07,2022-04-27 11:50:07,To GBP Rainy day,-1.74,0.00,GBP,COMPLETED,8800.57
TRANSFER,Current,2022-04-27 14:21:16,2022-04-27 14:21:16,To GBP Rainy day,-1.05,0.00,GBP,COMPLETED,8799.52
TRANSFER,Current,2022-04-27 14:50:10,2022-04-27 14:50:10,To GBP Rainy day,-2.25,0.00,GBP,COMPLETED,8797.27
TRANSFER,Current,2022-04-27 15:46:38,2022-04-27 15:46:38,To GBP Rainy day,-1.50,0.00,GBP,COMPLETED,8795.77
TRANSFER,Current,2022-04-27 18:29:03,2022-04-27 18:29:03,To GBP Rainy day,-1.20,0.00,GBP,COMPLETED,8794.57
TRANSFER,Current,2022-04-27 21:26:39,2022-04-27 21:26:39,To GBP Rainy day,-1.53,0.00,GBP,COMPLETED,8793.04
TRANSFER,Current,2022-04-27 21:30:31,2022-04-27 21:30:31,To GBP Rainy day,-0.03,0.00,GBP,COMPLETED,8793.01
TRANSFER,Current,2022-04-27 21:32:54,2022-04-27 21:32:54,To GBP Rainy day,-0.03,0.00,GBP,COMPLETED,8792.98
TRANSFER,Current,2022-04-27 21:34:19,2022-04-27 21:34:19,To GBP Rainy day,-1.53,0.00,GBP,COMPLETED,8791.45
TRANSFER,Current,2022-04-27 21:36:57,2022-04-27 21:36:57,To GBP Rainy day,-0.03,0.00,GBP,COMPLETED,8791.42
TRANSFER,Current,2022-04-28 01:41:39,2022-04-28 01:41:39,To GBP Rainy day,-2.40,0.00,GBP,COMPLETED,8789.02
TRANSFER,Current,2022-04-28 07:06:34,2022-04-28 07:06:34,To GBP Rainy day,-5.00,0.00,GBP,COMPLETED,8784.02
TRANSFER,Current,2022-04-28 10:07:39,2022-04-28 10:07:39,To GBP Rainy day,-1.95,0.00,GBP,COMPLETED,8782.07
CARD_PAYMENT,Current,2022-04-27 15:46:37,2022-04-28 10:08:17,Badiani Limite,-5.50,0.00,GBP,COMPLETED,8776.57
CARD_PAYMENT,Current,2022-04-27 10:19:03,2022-04-28 10:51:23,Starbucks,-3.35,0.00,GBP,COMPLETED,8773.22
CARD_PAYMENT,Current,2022-04-27 18:29:03,2022-04-28 11:23:15,Riverside Supermarket,-29.60,0.00,GBP,COMPLETED,8743.62
TRANSFER,Current,2022-04-28 11:40:57,2022-04-28 11:40:57,To GBP Rainy day,-1.95,0.00,GBP,COMPLETED,8741.67
CARD_PAYMENT,Current,2022-04-28 01:41:39,2022-04-28 12:28:02,Transport for London,-5.20,0.00,GBP,COMPLETED,8736.47
CARD_PAYMENT,Current,2022-04-27 14:50:10,2022-04-28 12:37:15,Pret,-3.25,0.00,GBP,COMPLETED,8733.22
TRANSFER,Current,2022-04-28 14:14:55,2022-04-28 14:14:55,To GBP Rainy day,-0.21,0.00,GBP,COMPLETED,8733.01
TRANSFER,Current,2022-04-28 14:32:00,2022-04-28 14:32:00,To GBP Rainy day,-2.40,0.00,GBP,COMPLETED,8730.61
CARD_PAYMENT,Current,2022-04-27 21:36:57,2022-04-28 16:51:35,Apple,-4.99,0.00,GBP,COMPLETED,8725.62
CARD_PAYMENT,Current,2022-04-27 21:32:54,2022-04-28 16:51:35,Apple,-4.99,0.00,GBP,COMPLETED,8720.63
CARD_PAYMENT,Current,2022-04-27 21:26:39,2022-04-28 16:51:36,Apple,-3.49,0.00,GBP,COMPLETED,8717.14
CARD_PAYMENT,Current,2022-04-27 21:30:31,2022-04-28 16:51:36,Apple,-5.99,0.00,GBP,COMPLETED,8711.15
CARD_PAYMENT,Current,2022-04-27 21:34:19,2022-04-28 16:51:36,Apple,-4.49,0.00,GBP,COMPLETED,8706.66
TRANSFER,Current,2022-04-28 18:31:29,2022-04-28 18:31:29,To GBP Rainy day,-0.51,0.00,GBP,COMPLETED,8706.15
TRANSFER,Current,2022-04-28 18:45:03,2022-04-28 18:45:03,To GBP Rainy day,-1.50,0.00,GBP,COMPLETED,8704.65
TRANSFER,Current,2022-04-29 01:00:00,2022-04-29 01:10:46,To Virgin Active,-139.99,0.00,GBP,COMPLETED,8564.66
TRANSFER,Current,2022-04-29 07:08:14,2022-04-29 07:08:14,To GBP Rainy day,-5.00,0.00,GBP,COMPLETED,8559.66
TRANSFER,Current,2022-04-29 09:30:30,2022-04-29 09:30:30,To GBP Rainy day,-0.33,0.00,GBP,COMPLETED,8559.33
CARD_PAYMENT,Current,2022-04-27 14:21:16,2022-04-29 09:31:21,Pret,-3.65,0.00,GBP,COMPLETED,8555.68
CARD_PAYMENT,Current,2022-04-28 11:40:55,2022-04-29 10:45:43,Starbucks,-3.35,0.00,GBP,COMPLETED,8552.33
CARD_PAYMENT,Current,2022-04-28 10:07:39,2022-04-29 10:45:44,Starbucks,-3.35,0.00,GBP,COMPLETED,8548.98
CARD_PAYMENT,Current,2022-04-28 14:14:54,2022-04-29 11:10:47,Co-op,-30.93,0.00,GBP,COMPLETED,8518.05
TRANSFER,Current,2022-04-29 11:12:03,2022-04-29 11:12:03,To GBP Rainy day,-1.95,0.00,GBP,COMPLETED,8516.10
CARD_PAYMENT,Current,2022-04-28 18:45:03,2022-04-29 11:12:42,Cafe Brera,-6.50,0.00,GBP,COMPLETED,8509.60
CARD_PAYMENT,Current,2022-04-28 18:31:29,2022-04-29 11:15:59,Waitrose & Partners,-53.83,0.00,GBP,COMPLETED,8455.77
CARD_PAYMENT,Current,2022-04-28 14:31:58,2022-04-29 12:03:35,Marugame Udon,-8.20,0.00,GBP,COMPLETED,8447.57
TRANSFER,Current,2022-04-29 13:22:30,2022-04-29 13:22:36,From WECTORY LTD,7556.64,0.00,GBP,COMPLETED,16004.21
TRANSFER,Current,2022-04-29 13:32:28,2022-04-29 13:32:28,To GBP Rainy day,-0.03,0.00,GBP,COMPLETED,16004.18
TRANSFER,Current,2022-04-29 13:45:18,2022-04-29 13:45:18,To GBP Rainy day,-1.50,0.00,GBP,COMPLETED,16002.68
TRANSFER,Current,2022-04-29 14:27:48,2022-04-29 14:27:48,To GBP Rainy day,-1.50,0.00,GBP,COMPLETED,16001.18
TRANSFER,Current,2022-04-29 18:05:59,2022-04-29 18:05:59,To GBP Rainy day,-3.00,0.00,GBP,COMPLETED,15998.18
TRANSFER,Current,2022-04-29 18:32:14,2022-04-29 18:32:14,To GBP Rainy day,-3.00,0.00,GBP,COMPLETED,15995.18
TRANSFER,Current,2022-04-30 03:18:26,2022-04-30 03:18:26,To GBP Rainy day,-3.00,0.00,GBP,COMPLETED,15992.18
TRANSFER,Current,2022-04-30 06:42:11,2022-04-30 06:42:11,To GBP Rainy day,-0.03,0.00,GBP,COMPLETED,15992.15
TRANSFER,Current,2022-04-30 07:07:09,2022-04-30 07:07:09,To GBP Rainy day,-5.00,0.00,GBP,COMPLETED,15987.15
TRANSFER,Current,2022-04-30 09:01:35,2022-04-30 09:01:37,To Holly Michael,-2450.00,0.00,GBP,COMPLETED,13537.15
CARD_PAYMENT,Current,2022-04-29 13:32:26,2022-04-30 09:35:11,Amazon Prime,-7.99,0.00,GBP,COMPLETED,13529.16
TRANSFER,Current,2022-04-30 09:39:04,2022-04-30 09:39:04,To GBP Savings,-5000.00,0.00,GBP,COMPLETED,8529.16
CARD_PAYMENT,Current,2022-04-29 13:45:17,2022-04-30 09:44:47,Catsteps C The Breakf,-31.50,0.00,GBP,COMPLETED,8497.66
TRANSFER,Current,2022-04-30 10:21:56,2022-04-30 10:21:56,To GBP Rainy day,-3.00,0.00,GBP,COMPLETED,8494.66
CARD_PAYMENT,Current,2022-04-29 11:11:36,2022-04-30 11:05:04,Starbucks,-3.35,0.00,GBP,COMPLETED,8491.31
CARD_PAYMENT,Current,2022-04-29 14:27:44,2022-04-30 11:30:29,Waitrose & Partners,-2.50,0.00,GBP,COMPLETED,8488.81
CARD_PAYMENT,Current,2022-04-29 09:30:30,2022-04-30 11:33:38,Waitrose,-239.89,0.00,GBP,COMPLETED,8248.92
CARD_PAYMENT,Current,2022-04-29 18:31:19,2022-04-30 11:40:37,Riverside Supermarket,-46.00,0.00,GBP,COMPLETED,8202.92
TRANSFER,Current,2022-04-30 12:55:28,2022-04-30 12:55:28,To GBP Rainy day,-1.50,0.00,GBP,COMPLETED,8201.42
TRANSFER,Current,2022-04-30 13:39:13,2022-04-30 13:39:13,To GBP Rainy day,-2.55,0.00,GBP,COMPLETED,8198.87
CARD_PAYMENT,Current,2022-04-30 15:45:49,,Canterbury City Council,-6.00,0.00,GBP,REVERTED,
TRANSFER,Current,2022-04-30 15:45:49,2022-04-30 15:45:49,To GBP Rainy day,-3.00,0.00,GBP,COMPLETED,8195.87
TRANSFER,Current,2022-04-30 18:53:15,2022-04-30 18:53:15,To GBP Rainy day,-0.09,0.00,GBP,COMPLETED,8195.78
TRANSFER,Current,2022-05-01 01:32:36,2022-05-01 01:32:36,To GBP Rainy day,-0.60,0.00,GBP,COMPLETED,8195.18
TRANSFER,Current,2022-05-01 07:10:05,2022-05-01 07:10:05,To GBP Rainy day,-5.00,0.00,GBP,COMPLETED,8190.18
CARD_PAYMENT,Current,2022-04-30 06:42:11,2022-05-01 09:27:20,Netflix,-10.99,0.00,GBP,COMPLETED,8179.19
CARD_PAYMENT,Current,2022-04-30 12:55:28,2022-05-01 09:50:56,Trainline,-48.50,0.00,GBP,COMPLETED,8130.69
CARD_PAYMENT,Current,2022-04-30 03:18:26,2022-05-01 10:07:21,Loqbox,-50.00,0.00,GBP,COMPLETED,8080.69
CARD_PAYMENT,Current,2022-04-30 10:21:56,2022-05-01 10:11:31,Trainline,-30.00,0.00,GBP,COMPLETED,8050.69
CARD_PAYMENT,Current,2022-04-30 13:39:12,2022-05-01 11:32:31,Pinkberry,-7.15,0.00,GBP,COMPLETED,8043.54
CARD_PAYMENT,Current,2022-04-29 18:05:58,2022-05-01 11:32:31,No 35 Mackenzie Walk,-7.00,0.00,GBP,COMPLETED,8036.54
TRANSFER,Current,2022-05-01 18:01:29,2022-05-01 18:01:29,To GBP Rainy day,-3.00,0.00,GBP,COMPLETED,8033.54
TRANSFER,Current,2022-05-01 19:30:16,2022-05-01 19:30:16,To GBP Rainy day,-3.00,0.00,GBP,COMPLETED,8030.54
TRANSFER,Current,2022-05-01 19:50:47,2022-05-01 19:50:47,To GBP Rainy day,-3.00,0.00,GBP,COMPLETED,8027.54
TRANSFER,Current,2022-05-01 19:56:22,2022-05-01 19:56:22,To GBP Rainy day,-2.40,0.00,GBP,COMPLETED,8025.14
TRANSFER,Current,2022-05-01 20:10:04,2022-05-01 20:10:04,To GBP Rainy day,-1.35,0.00,GBP,COMPLETED,8023.79
TRANSFER,Current,2022-05-01 20:26:35,2022-05-01 20:26:35,To GBP Rainy day,-1.35,0.00,GBP,COMPLETED,8022.44
TRANSFER,Current,2022-05-01 21:01:17,2022-05-01 21:01:17,To GBP Rainy day,-1.35,0.00,GBP,COMPLETED,8021.09
TRANSFER,Current,2022-05-01 22:18:52,2022-05-01 22:18:52,To GBP Rainy day,-0.15,0.00,GBP,COMPLETED,8020.94
TRANSFER,Current,2022-05-02 01:23:54,2022-05-02 01:23:54,To GBP Rainy day,-1.20,0.00,GBP,COMPLETED,8019.74
TRANSFER,Current,2022-05-02 07:22:04,2022-05-02 07:22:04,To GBP Rainy day,-5.00,0.00,GBP,COMPLETED,8014.74
TRANSFER,Current,2022-05-02 09:01:29,2022-05-02 09:01:29,To Aleksandra Balabanova,-600.00,0.00,GBP,COMPLETED,7414.74
TRANSFER,Current,2022-05-02 09:01:29,2022-05-02 09:01:29,To Natalia Balabanova,-2000.00,0.00,GBP,COMPLETED,5414.74
TRANSFER,Current,2022-05-02 09:46:24,2022-05-02 09:46:24,To GBP Rainy day,-0.30,0.00,GBP,COMPLETED,5414.44
CARD_PAYMENT,Current,2022-05-01 01:32:36,2022-05-02 10:07:40,Transport for London,-4.80,0.00,GBP,COMPLETED,5409.64
CARD_PAYMENT,Current,2022-05-01 18:01:29,2022-05-02 11:32:34,Booking,-188.00,0.00,GBP,COMPLETED,5221.64
CARD_PAYMENT,Current,2022-04-30 18:53:15,2022-05-02 12:59:33,Côte Brasserie,-123.97,0.00,GBP,COMPLETED,5097.67
CARD_PAYMENT,Current,2022-05-01 21:01:16,2022-05-02 13:15:38,Latymers,-6.55,0.00,GBP,COMPLETED,5091.12
CARD_PAYMENT,Current,2022-05-01 19:50:46,2022-05-02 13:15:38,Latymers,-37.00,0.00,GBP,COMPLETED,5054.12
CARD_PAYMENT,Current,2022-05-01 22:18:52,2022-05-02 13:15:38,St Pauls Hotel,-32.95,0.00,GBP,COMPLETED,5021.17
CARD_PAYMENT,Current,2022-05-01 19:56:22,2022-05-02 13:15:38,Latymers,-32.20,0.00,GBP,COMPLETED,4988.97
CARD_PAYMENT,Current,2022-05-01 20:10:04,2022-05-02 13:15:38,Latymers,-6.55,0.00,GBP,COMPLETED,4982.42
CARD_PAYMENT,Current,2022-05-01 20:26:35,2022-05-02 13:15:38,Latymers,-6.55,0.00,GBP,COMPLETED,4975.87
TRANSFER,Current,2022-05-02 13:51:03,2022-05-02 13:51:03,To GBP Rainy day,-0.60,0.00,GBP,COMPLETED,4975.27
CARD_PAYMENT,Current,2022-05-02 01:23:54,2022-05-02 14:12:33,Transport for London,-2.60,0.00,GBP,COMPLETED,4972.67
TRANSFER,Current,2022-05-02 15:52:57,2022-05-02 15:52:57,To GBP Rainy day,-1.80,0.00,GBP,COMPLETED,4970.87
TRANSFER,Current,2022-05-02 18:11:23,2022-05-02 18:11:23,To GBP Rainy day,-1.35,0.00,GBP,COMPLETED,4969.52
TRANSFER,Current,2022-05-03 01:20:55,2022-05-03 01:20:55,To GBP Rainy day,-0.30,0.00,GBP,COMPLETED,4969.22
TRANSFER,Current,2022-05-03 07:05:21,2022-05-03 07:05:21,To GBP Rainy day,-5.00,0.00,GBP,COMPLETED,4964.22
TRANSFER,Current,2022-05-03 10:21:17,2022-05-03 10:21:17,To GBP Rainy day,-1.95,0.00,GBP,COMPLETED,4962.27
TOPUP,Current,2022-05-03 11:30:12,2022-05-03 11:30:13,Payment from Henley   Partners Uk Ltd,1533.11,0.00,GBP,COMPLETED,6495.38
CARD_PAYMENT,Current,2022-05-02 13:51:03,2022-05-03 12:40:22,Pembroke Lodge,-19.80,0.00,GBP,COMPLETED,6475.58
CARD_PAYMENT,Current,2022-05-02 15:52:57,2022-05-03 12:40:22,Pembroke Lodge,-5.40,0.00,GBP,COMPLETED,6470.18
CARD_PAYMENT,Current,2022-05-02 18:11:23,2022-05-03 13:27:11,Sainsbury's,-21.55,0.00,GBP,COMPLETED,6448.63
TRANSFER,Current,2022-05-03 13:37:47,2022-05-03 13:37:47,To GBP Rainy day,-1.95,0.00,GBP,COMPLETED,6446.68
CARD_PAYMENT,Current,2022-05-03 01:20:55,2022-05-03 14:00:30,Transport for London,-4.90,0.00,GBP,COMPLETED,6441.78
TRANSFER,Current,2022-05-03 15:14:35,2022-05-03 15:14:35,To GBP Rainy day,-3.00,0.00,GBP,COMPLETED,6438.78
TRANSFER,Current,2022-05-03 18:30:41,2022-05-03 18:30:41,To GBP Rainy day,-3.00,0.00,GBP,COMPLETED,6435.78
TRANSFER,Current,2022-05-03 18:43:03,2022-05-03 18:43:03,To GBP Rainy day,-1.95,0.00,GBP,COMPLETED,6433.83
TRANSFER,Current,2022-05-03 19:16:29,2022-05-03 19:16:29,To GBP Rainy day,-3.00,0.00,GBP,COMPLETED,6430.83
TRANSFER,Current,2022-05-03 19:38:36,2022-05-03 19:38:36,To GBP Rainy day,-0.15,0.00,GBP,COMPLETED,6430.68
TRANSFER,Current,2022-05-03 20:54:20,2022-05-03 20:54:20,To GBP Rainy day,-3.00,0.00,GBP,COMPLETED,6427.68
TRANSFER,Current,2022-05-03 21:18:05,2022-05-03 21:18:05,To GBP Rainy day,-1.50,0.00,GBP,COMPLETED,6426.18
TRANSFER,Current,2022-05-03 21:48:12,2022-05-03 21:48:12,To GBP Rainy day,-1.50,0.00,GBP,COMPLETED,6424.68
TRANSFER,Current,2022-05-03 22:15:05,2022-05-03 22:15:05,To GBP Rainy day,-0.36,0.00,GBP,COMPLETED,6424.32
TRANSFER,Current,2022-05-03 22:52:00,2022-05-03 22:52:00,To GBP Rainy day,-2.55,0.00,GBP,COMPLETED,6421.77
TRANSFER,Current,2022-05-04 01:38:28,2022-05-04 01:38:28,To GBP Rainy day,-2.40,0.00,GBP,COMPLETED,6419.37
TRANSFER,Current,2022-05-04 07:05:24,2022-05-04 07:05:24,To GBP Rainy day,-5.00,0.00,GBP,COMPLETED,6414.37
CARD_PAYMENT,Current,2022-05-03 19:38:35,2022-05-04 11:32:13,Darwin And Wallace Lim,-101.95,0.00,GBP,COMPLETED,6312.42
CARD_PAYMENT,Current,2022-05-03 15:14:34,2022-05-04 11:32:59,Apple Store,-277.00,0.00,GBP,COMPLETED,6035.42
CARD_PAYMENT,Current,2022-05-03 19:16:29,2022-05-04 11:35:49,Darwin And Wallace Lim,-7.00,0.00,GBP,COMPLETED,6028.42
CARD_PAYMENT,Current,2022-05-03 18:43:03,2022-05-04 11:35:49,Darwin And Wallace Lim,-73.35,0.00,GBP,COMPLETED,5955.07
TRANSFER,Current,2022-05-04 11:41:44,2022-05-04 11:41:44,To GBP Rainy day,-3.00,0.00,GBP,COMPLETED,5952.07
CARD_PAYMENT,Current,2022-05-03 10:21:17,2022-05-04 11:43:13,Starbucks,-3.35,0.00,GBP,COMPLETED,5948.72
CARD_PAYMENT,Current,2022-05-03 13:37:47,2022-05-04 11:43:44,Starbucks,-3.35,0.00,GBP,COMPLETED,5945.37
CARD_PAYMENT,Current,2022-05-02 09:46:24,2022-05-04 12:01:02,St Pauls Hotel,-39.90,0.00,GBP,COMPLETED,5905.47
CARD_PAYMENT,Current,2022-05-01 19:30:16,2022-05-04 12:01:02,St Pauls Hotel,-30.00,0.00,GBP,COMPLETED,5875.47
TRANSFER,Current,2022-05-04 13:09:10,2022-05-04 13:09:10,To GBP Rainy day,-1.80,0.00,GBP,COMPLETED,5873.67
CARD_PAYMENT,Current,2022-05-04 01:38:28,2022-05-04 13:12:37,Transport for London,-3.20,0.00,GBP,COMPLETED,5870.47
CARD_PAYMENT,Current,2022-05-03 22:51:59,2022-05-04 13:23:44,The Grapes,-6.15,0.00,GBP,COMPLETED,5864.32
TRANSFER,Current,2022-05-04 18:55:30,2022-05-04 18:55:30,To GBP Rainy day,-1.05,0.00,GBP,COMPLETED,5863.27
TRANSFER,Current,2022-05-04 19:23:22,2022-05-04 19:23:22,To GBP Rainy day,-1.80,0.00,GBP,COMPLETED,5861.47
TRANSFER,Current,2022-05-04 19:54:43,2022-05-04 19:54:43,To GBP Rainy day,-2.31,0.00,GBP,COMPLETED,5859.16
TRANSFER,Current,2022-05-05 07:06:53,2022-05-05 07:06:53,To GBP Rainy day,-5.00,0.00,GBP,COMPLETED,5854.16
TRANSFER,Current,2022-05-05 09:38:43,2022-05-05 09:38:43,To GBP Rainy day,-1.95,0.00,GBP,COMPLETED,5852.21
CARD_PAYMENT,Current,2022-05-04 19:54:43,2022-05-05 10:17:15,Airbnb,-336.23,0.00,GBP,COMPLETED,5515.98
CARD_PAYMENT,Current,2022-05-03 21:16:54,2022-05-05 11:01:46,No 35 Mackenzie Walk,-15.50,0.00,GBP,COMPLETED,5500.48
CARD_PAYMENT,Current,2022-05-03 22:10:44,2022-05-05 11:01:46,No 35 Mackenzie Walk,-7.88,0.00,GBP,COMPLETED,5492.60
CARD_PAYMENT,Current,2022-05-03 21:48:11,2022-05-05 11:01:46,No 35 Mackenzie Walk,-15.50,0.00,GBP,COMPLETED,5477.10
CARD_PAYMENT,Current,2022-05-03 20:54:19,2022-05-05 11:01:47,No 35 Mackenzie Walk,-6.00,0.00,GBP,COMPLETED,5471.10
CARD_PAYMENT,Current,2022-05-03 18:30:41,2022-05-05 11:01:47,No 35 Mackenzie Walk,-7.00,0.00,GBP,COMPLETED,5464.10
TRANSFER,Current,2022-05-05 11:50:26,2022-05-05 11:50:26,To GBP Rainy day,-1.95,0.00,GBP,COMPLETED,5462.15
CARD_PAYMENT,Current,2022-05-04 13:09:09,2022-05-05 11:56:23,Waitrose & Partners,-2.40,0.00,GBP,COMPLETED,5459.75
CARD_PAYMENT,Current,2022-05-04 18:55:30,2022-05-05 11:56:25,Waitrose & Partners,-9.65,0.00,GBP,COMPLETED,5450.10
CARD_PAYMENT,Current,2022-05-04 19:23:22,2022-05-05 12:13:17,Riverside Supermarket,-44.40,0.00,GBP,COMPLETED,5405.70
CARD_PAYMENT,Current,2022-05-04 11:41:43,2022-05-05 12:27:41,Marugame Udon,-14.00,0.00,GBP,COMPLETED,5391.70
TRANSFER,Current,2022-05-05 13:22:46,2022-05-05 13:22:46,To GBP Rainy day,-0.75,0.00,GBP,COMPLETED,5390.95
TRANSFER,Current,2022-05-05 15:27:26,2022-05-05 15:27:26,To GBP Rainy day,-0.90,0.00,GBP,COMPLETED,5390.05
TRANSFER,Current,2022-05-05 15:41:31,2022-05-05 15:41:31,To GBP Rainy day,-2.10,0.00,GBP,COMPLETED,5387.95
TRANSFER,Current,2022-05-06 01:46:06,2022-05-06 01:46:06,To GBP Rainy day,-0.60,0.00,GBP,COMPLETED,5387.35
TRANSFER,Current,2022-05-06 07:08:21,2022-05-06 07:08:21,To GBP Rainy day,-5.00,0.00,GBP,COMPLETED,5382.35
CARD_PAYMENT,Current,2022-05-05 15:41:13,2022-05-06 10:52:36,Attendant,-3.30,0.00,GBP,COMPLETED,5379.05
CARD_PAYMENT,Current,2022-05-05 11:50:26,2022-05-06 12:23:40,Starbucks,-3.35,0.00,GBP,COMPLETED,5375.70
CARD_PAYMENT,Current,2022-05-05 09:38:42,2022-05-06 12:23:40,Starbucks,-3.35,0.00,GBP,COMPLETED,5372.35
TRANSFER,Current,2022-05-06 12:44:47,2022-05-06 12:44:47,To GBP Rainy day,-0.15,0.00,GBP,COMPLETED,5372.20
CARD_PAYMENT,Current,2022-05-05 13:22:46,2022-05-06 13:36:45,Marugame Udon,-6.75,0.00,GBP,COMPLETED,5365.45
CARD_PAYMENT,Current,2022-05-05 15:27:25,2022-05-06 14:22:47,Attendant,-3.70,0.00,GBP,COMPLETED,5361.75
CARD_PAYMENT,Current,2022-05-06 01:46:06,2022-05-06 14:25:15,Transport for London,-5.80,0.00,GBP,COMPLETED,5355.95
TRANSFER,Current,2022-05-06 14:41:53,2022-05-06 14:41:53,To GBP Rainy day,-0.75,0.00,GBP,COMPLETED,5355.20
TRANSFER,Current,2022-05-06 15:16:31,2022-05-06 15:16:31,To GBP Rainy day,-1.65,0.00,GBP,COMPLETED,5353.55
TRANSFER,Current,2022-05-06 18:30:04,2022-05-06 18:30:04,To GBP Rainy day,-1.50,0.00,GBP,COMPLETED,5352.05
TRANSFER,Current,2022-05-06 18:33:35,2022-05-06 18:33:35,To GBP Rainy day,-1.20,0.00,GBP,COMPLETED,5350.85
TRANSFER,Current,2022-05-06 19:39:06,2022-05-06 19:39:06,To GBP Rainy day,-2.04,0.00,GBP,COMPLETED,5348.81
TRANSFER,Current,2022-05-06 21:00:48,2022-05-06 21:00:48,To GBP Rainy day,-0.60,0.00,GBP,COMPLETED,5348.21
TRANSFER,Current,2022-05-06 21:13:22,2022-05-06 21:13:22,To GBP Rainy day,-1.50,0.00,GBP,COMPLETED,5346.71
TRANSFER,Current,2022-05-06 22:22:41,2022-05-06 22:22:41,To GBP Rainy day,-1.50,0.00,GBP,COMPLETED,5345.21
TRANSFER,Current,2022-05-06 23:11:46,2022-05-06 23:11:46,To GBP Rainy day,-0.30,0.00,GBP,COMPLETED,5344.91
TRANSFER,Current,2022-05-07 01:38:51,2022-05-07 01:38:51,To GBP Rainy day,-0.90,0.00,GBP,COMPLETED,5344.01
TRANSFER,Current,2022-05-07 07:05:36,2022-05-07 07:05:36,To GBP Rainy day,-5.00,0.00,GBP,COMPLETED,5339.01
CARD_PAYMENT,Current,2022-05-06 12:44:47,2022-05-07 11:10:43,Serpentine Bar & Kitchen,-4.95,0.00,GBP,COMPLETED,5334.06
CARD_PAYMENT,Current,2022-05-06 14:41:53,2022-05-07 11:32:24,Starbucks,-1.75,0.00,GBP,COMPLETED,5332.31
CARD_PAYMENT,Current,2022-05-06 18:30:04,2022-05-07 12:11:31,Wasabi Sushi & Bento,-27.50,0.00,GBP,COMPLETED,5304.81
CARD_PAYMENT,Current,2022-05-06 15:16:30,2022-05-07 12:11:34,Wasabi Sushi & Bento,-1.45,0.00,GBP,COMPLETED,5303.36
CARD_PAYMENT,Current,2022-05-06 18:33:34,2022-05-07 12:39:39,Cafe Brera,-18.60,0.00,GBP,COMPLETED,5284.76
TRANSFER,Current,2022-05-07 13:29:42,2022-05-07 13:29:42,To GBP Rainy day,-2.40,0.00,GBP,COMPLETED,5282.36
TRANSFER,Current,2022-05-07 13:44:18,2022-05-07 13:44:18,To GBP Rainy day,-2.40,0.00,GBP,COMPLETED,5279.96
TRANSFER,Current,2022-05-07 13:52:56,2022-05-07 13:52:56,To GBP Rainy day,-1.50,0.00,GBP,COMPLETED,5278.46
CARD_PAYMENT,Current,2022-05-07 01:38:50,2022-05-07 14:17:22,Transport for London,-7.70,0.00,GBP,COMPLETED,5270.76
TRANSFER,Current,2022-05-07 17:58:36,2022-05-07 17:58:36,To GBP Rainy day,-0.15,0.00,GBP,COMPLETED,5270.61
TRANSFER,Current,2022-05-07 19:24:35,2022-05-07 19:24:35,To GBP Rainy day,-2.10,0.00,GBP,COMPLETED,5268.51
TRANSFER,Current,2022-05-07 19:31:28,2022-05-07 19:31:28,To GBP Rainy day,-0.30,0.00,GBP,COMPLETED,5268.21
TRANSFER,Current,2022-05-07 20:32:28,2022-05-07 20:32:28,To GBP Rainy day,-1.20,0.00,GBP,COMPLETED,5267.01
CARD_PAYMENT,Current,2022-05-06 19:39:06,2022-05-07 20:37:11,Apple,-14.32,0.00,GBP,COMPLETED,5252.69
TRANSFER,Current,2022-05-08 01:30:57,2022-05-08 01:30:57,To GBP Rainy day,-0.60,0.00,GBP,COMPLETED,5252.09
TRANSFER,Current,2022-05-08 07:05:32,2022-05-08 07:05:32,To GBP Rainy day,-5.00,0.00,GBP,COMPLETED,5247.09
TRANSFER,Current,2022-05-08 08:57:05,2022-05-08 08:57:05,To GBP Rainy day,-0.06,0.00,GBP,COMPLETED,5247.03
TRANSFER,Current,2022-05-08 08:57:33,2022-05-08 08:57:33,To GBP Rainy day,-1.23,0.00,GBP,COMPLETED,5245.80
TRANSFER,Current,2022-05-08 10:11:33,2022-05-08 10:11:33,To GBP Rainy day,-3.00,0.00,GBP,COMPLETED,5242.80
TRANSFER,Current,2022-05-08 10:12:32,2022-05-08 10:12:32,To GBP Rainy day,-3.00,0.00,GBP,COMPLETED,5239.80
CARD_PAYMENT,Current,2022-05-07 19:31:28,2022-05-08 10:14:10,Docklands Food N Wine,-29.90,0.00,GBP,COMPLETED,5209.90
CARD_PAYMENT,Current,2022-05-06 23:11:45,2022-05-08 10:16:19,McDonald's,-4.90,0.00,GBP,COMPLETED,5205.00
TRANSFER,Current,2022-05-08 10:23:19,2022-05-08 10:23:19,To GBP Rainy day,-1.50,0.00,GBP,COMPLETED,5203.50
TRANSFER,Current,2022-05-08 11:06:03,2022-05-08 11:06:03,To GBP Rainy day,-0.90,0.00,GBP,COMPLETED,5202.60
CARD_PAYMENT,Current,2022-05-06 21:13:22,2022-05-08 12:04:41,Exmouth Arms,-16.50,0.00,GBP,COMPLETED,5186.10
CARD_PAYMENT,Current,2022-05-06 22:22:41,2022-05-08 12:04:42,Exmouth Arms,-11.50,0.00,GBP,COMPLETED,5174.60
CARD_PAYMENT,Current,2022-05-06 21:00:48,2022-05-08 12:04:42,Exmouth Arms,-5.80,0.00,GBP,COMPLETED,5168.80
CARD_PAYMENT,Current,2022-05-07 13:52:55,2022-05-08 12:06:36,Starbucks,-3.50,0.00,GBP,COMPLETED,5165.30
CARD_PAYMENT,Current,2022-05-07 17:58:36,2022-05-08 12:06:36,Starbucks,-12.95,0.00,GBP,COMPLETED,5152.35
CARD_PAYMENT,Current,2022-05-07 13:44:18,2022-05-08 13:16:11,GAIL's Bakery,-11.20,0.00,GBP,COMPLETED,5141.15
CARD_PAYMENT,Current,2022-05-07 13:29:42,2022-05-08 13:16:12,GAIL's Bakery,-27.20,0.00,GBP,COMPLETED,5113.95
CARD_PAYMENT,Current,2022-05-07 19:24:34,2022-05-08 14:36:06,Sainsbury's,-33.30,0.00,GBP,COMPLETED,5080.65
CARD_PAYMENT,Current,2022-05-08 01:30:57,2022-05-08 14:44:44,Transport for London,-5.80,0.00,GBP,COMPLETED,5074.85
TRANSFER,Current,2022-05-08 15:19:59,2022-05-08 15:19:59,To GBP Rainy day,-1.20,0.00,GBP,COMPLETED,5073.65
TRANSFER,Current,2022-05-08 16:30:45,2022-05-08 16:30:45,To GBP Rainy day,-2.58,0.00,GBP,COMPLETED,5071.07
TRANSFER,Current,2022-05-08 19:10:51,2022-05-08 19:10:51,To GBP Rainy day,-0.84,0.00,GBP,COMPLETED,5070.23
TRANSFER,Current,2022-05-08 19:51:05,2022-05-08 19:51:05,To GBP Rainy day,-1.86,0.00,GBP,COMPLETED,5068.37
TRANSFER,Current,2022-05-09 01:20:58,2022-05-09 01:20:58,To GBP Rainy day,-1.20,0.00,GBP,COMPLETED,5067.17
TRANSFER,Current,2022-05-09 01:29:37,2022-05-09 01:29:37,To GBP Rainy day,-1.20,0.00,GBP,COMPLETED,5065.97
TRANSFER,Current,2022-05-09 06:57:52,2022-05-09 06:57:52,To GBP Rainy day,-2.58,0.00,GBP,COMPLETED,5063.39
TRANSFER,Current,2022-05-09 07:03:16,2022-05-09 07:03:16,To GBP Rainy day,-1.65,0.00,GBP,COMPLETED,5061.74
TRANSFER,Current,2022-05-09 07:21:51,2022-05-09 07:21:51,To GBP Rainy day,-5.00,0.00,GBP,COMPLETED,5056.74
CARD_PAYMENT,Current,2022-05-08 10:11:32,2022-05-09 10:47:50,Pg Group Vending,-5.00,0.00,GBP,COMPLETED,5051.74
CARD_PAYMENT,Current,2022-05-08 10:12:32,2022-05-09 10:47:50,Pg Group Vending,-5.00,0.00,GBP,COMPLETED,5046.74
CARD_PAYMENT,Current,2022-05-08 11:06:03,2022-05-09 11:22:50,Costa Coffee,-5.70,0.00,GBP,COMPLETED,5041.04
TRANSFER,Current,2022-05-09 11:45:27,2022-05-09 11:45:28,To GBP Rainy day,-2.19,0.00,GBP,COMPLETED,5038.85
CARD_PAYMENT,Current,2022-05-08 19:51:05,2022-05-09 12:56:05,Carrefour,-47.38,0.47,GBP,COMPLETED,4991.00
CARD_PAYMENT,Current,2022-05-08 08:57:05,2022-05-09 13:14:17,London Bridge,-4.98,0.00,GBP,COMPLETED,4986.02
CARD_PAYMENT,Current,2022-05-08 08:57:33,2022-05-09 13:14:17,London Bridge,-1.59,0.00,GBP,COMPLETED,4984.43
CARD_PAYMENT,Current,2022-05-08 10:23:19,2022-05-09 13:14:39,WHSmith,-2.50,0.00,GBP,COMPLETED,4981.93
TRANSFER,Current,2022-05-09 13:22:28,2022-05-09 13:22:28,To GBP Rainy day,-0.15,0.00,GBP,COMPLETED,4981.78
CARD_PAYMENT,Current,2022-05-08 15:19:58,2022-05-09 13:42:48,Chef Express,-3.60,0.04,GBP,COMPLETED,4978.14
CARD_PAYMENT,Current,2022-05-08 16:30:45,2022-05-09 14:08:22,6645 Lima 14,-11.14,0.11,GBP,COMPLETED,4966.89
TRANSFER,Current,2022-05-09 14:24:17,2022-05-09 14:24:17,To GBP Rainy day,-0.24,0.00,GBP,COMPLETED,4966.65
TRANSFER,Current,2022-05-09 14:27:22,2022-05-09 14:27:22,To GBP Rainy day,-0.81,0.00,GBP,COMPLETED,4965.84
CARD_PAYMENT,Current,2022-05-09 01:20:58,2022-05-09 14:34:51,Transport for London,-2.60,0.00,GBP,COMPLETED,4963.24
CARD_PAYMENT,Current,2022-05-09 01:29:37,2022-05-09 14:37:23,Transport for London,-1.60,0.00,GBP,COMPLETED,4961.64
TRANSFER,Current,2022-05-09 20:17:46,2022-05-09 20:17:46,To GBP Rainy day,-1.17,0.00,GBP,COMPLETED,4960.47
TRANSFER,Current,2022-05-09 22:38:27,2022-05-09 22:38:27,To GBP Rainy day,-3.00,0.00,GBP,COMPLETED,4957.47
TRANSFER,Current,2022-05-10 07:05:52,2022-05-10 07:05:52,To GBP Rainy day,-5.00,0.00,GBP,COMPLETED,4952.47
ATM,Current,2022-05-09 07:05:35,2022-05-10 09:56:26,Cash at Pza Campo De Fiori 52,-80.44,0.00,GBP,COMPLETED,4872.03
TRANSFER,Current,2022-05-10 10:04:23,2022-05-10 10:04:23,To GBP Rainy day,-1.41,0.00,GBP,COMPLETED,4870.62
CARD_PAYMENT,Current,2022-05-07 20:32:28,2022-05-10 10:10:01,Trainline,-14.60,0.00,GBP,COMPLETED,4856.02
CARD_PAYMENT,Current,2022-05-08 19:10:50,2022-05-10 10:14:56,Reserva,-147.72,1.48,GBP,COMPLETED,4706.82
TRANSFER,Current,2022-05-10 10:21:35,2022-05-10 10:21:35,To GBP Rainy day,-2.97,0.00,GBP,COMPLETED,4703.85
CARD_PAYMENT,Current,2022-05-09 13:22:28,2022-05-10 12:02:56,Presidio Gourme,-15.95,0.00,GBP,COMPLETED,4687.90
CARD_PAYMENT,Current,2022-05-09 07:03:16,2022-05-10 12:36:29,Pony Express ® ROMA,-10.45,0.00,GBP,COMPLETED,4677.45
CARD_PAYMENT,Current,2022-05-09 22:38:27,2022-05-10 13:05:44,EE,-25.00,0.00,GBP,COMPLETED,4652.45
TRANSFER,Current,2022-05-10 13:25:49,2022-05-10 13:25:49,To GBP Rainy day,-0.87,0.00,GBP,COMPLETED,4651.58
CARD_PAYMENT,Current,2022-05-09 14:27:21,2022-05-10 13:33:01,Garden Fruit Snc,-36.73,0.00,GBP,COMPLETED,4614.85
CARD_PAYMENT,Current,2022-05-09 20:17:46,2022-05-10 13:33:49,4 Fiumi,-103.61,0.00,GBP,COMPLETED,4511.24
CARD_PAYMENT,Current,2022-05-09 14:24:17,2022-05-10 13:43:40,Anastasia Di Nicosia Giu,-23.92,0.00,GBP,COMPLETED,4487.32
TRANSFER,Current,2022-05-10 15:37:08,2022-05-10 15:37:08,To GBP Rainy day,-1.74,0.00,GBP,COMPLETED,4485.58
TRANSFER,Current,2022-05-10 21:54:29,2022-05-10 21:54:29,To GBP Rainy day,-2.43,0.00,GBP,COMPLETED,4483.15
TRANSFER,Current,2022-05-10 22:10:56,2022-05-10 22:10:56,To GBP Rainy day,-2.58,0.00,GBP,COMPLETED,4480.57
TRANSFER,Current,2022-05-11 06:23:19,2022-05-11 06:23:19,To GBP Rainy day,-0.21,0.00,GBP,COMPLETED,4480.36
TRANSFER,Current,2022-05-11 07:05:27,2022-05-11 07:05:27,To GBP Rainy day,-5.00,0.00,GBP,COMPLETED,4475.36
ATM,Current,2022-05-11 05:47:29,2022-05-11 09:41:49,Cash at T3 Q 6.00 - Part Land,-63.24,0.00,GBP,COMPLETED,4412.12
CARD_PAYMENT,Current,2022-05-09 11:45:27,2022-05-11 10:27:00,Caffé Palladio,-10.27,0.00,GBP,COMPLETED,4401.85
CARD_PAYMENT,Current,2022-05-09 06:57:52,2022-05-11 10:27:00,Al Biscione Cafė,-8.14,0.00,GBP,COMPLETED,4393.71
TRANSFER,Current,2022-05-11 10:30:23,2022-05-11 10:30:23,To GBP Rainy day,-1.50,0.00,GBP,COMPLETED,4392.21
TRANSFER,Current,2022-05-11 11:19:55,2022-05-11 11:19:55,To GBP Rainy day,-2.40,0.00,GBP,COMPLETED,4389.81
TRANSFER,Current,2022-05-11 12:08:41,2022-05-11 12:08:41,To GBP Rainy day,-0.03,0.00,GBP,COMPLETED,4389.78
TRANSFER,Current,2022-05-11 12:54:06,2022-05-11 12:54:06,To GBP Rainy day,-1.95,0.00,GBP,COMPLETED,4387.83
CARD_PAYMENT,Current,2022-05-10 13:25:49,2022-05-11 14:18:35,404 Name Not Found,-13.71,0.00,GBP,COMPLETED,4374.12
TRANSFER,Current,2022-05-11 14:22:13,2022-05-11 14:22:13,To GBP Rainy day,-2.79,0.00,GBP,COMPLETED,4371.33
TRANSFER,Current,2022-05-11 14:34:29,2022-05-11 14:34:29,To GBP Rainy day,-0.75,0.00,GBP,COMPLETED,4370.58
CARD_PAYMENT,Current,2022-05-10 10:21:34,2022-05-11 14:35:42,Caffè dello Studente,-3.01,0.00,GBP,COMPLETED,4367.57
CARD_PAYMENT,Current,2022-05-10 15:37:08,2022-05-11 14:35:42,Caffè dello Studente,-6.42,0.00,GBP,COMPLETED,4361.15
TRANSFER,Current,2022-05-11 17:17:35,2022-05-11 17:17:35,To GBP Rainy day,-0.15,0.00,GBP,COMPLETED,4361.00
TRANSFER,Current,2022-05-12 01:00:00,2022-05-12 01:13:15,To Billing Better,-179.16,0.00,GBP,COMPLETED,4181.84
TRANSFER,Current,2022-05-12 01:45:13,2022-05-12 01:45:13,To GBP Rainy day,-2.40,0.00,GBP,COMPLETED,4179.44
TRANSFER,Current,2022-05-12 07:06:17,2022-05-12 07:06:17,To GBP Rainy day,-5.00,0.00,GBP,COMPLETED,4174.44
TRANSFER,Current,2022-05-12 09:50:57,2022-05-12 09:50:57,To GBP Rainy day,-2.25,0.00,GBP,COMPLETED,4172.19
CARD_PAYMENT,Current,2022-05-11 10:30:23,2022-05-12 10:04:39,Trainline,-16.50,0.00,GBP,COMPLETED,4155.69
CARD_PAYMENT,Current,2022-05-10 21:54:28,2022-05-12 10:16:10,Open Management,-46.19,0.00,GBP,COMPLETED,4109.50
CARD_PAYMENT,Current,2022-05-10 22:10:55,2022-05-12 10:16:10,Open Management,-5.14,0.00,GBP,COMPLETED,4104.36
CARD_PAYMENT,Current,2022-05-10 10:04:23,2022-05-12 10:16:10,Colosseum Palace Star S.r,-161.53,0.00,GBP,COMPLETED,3942.83
CARD_PAYMENT,Current,2022-04-30 01:00:00,2022-05-12 10:46:52,Canterbury City Council,-6.00,0.00,GBP,COMPLETED,3936.83
TRANSFER,Current,2022-05-12 10:46:52,2022-05-12 10:46:52,To GBP Rainy day,-3.00,0.00,GBP,COMPLETED,3933.83
TRANSFER,Current,2022-05-12 10:48:52,2022-05-12 10:48:52,To GBP Rainy day,-1.95,0.00,GBP,COMPLETED,3931.88
CARD_PAYMENT,Current,2022-05-11 11:19:55,2022-05-12 11:20:01,Costa Coffee,-8.20,0.00,GBP,COMPLETED,3923.68
TRANSFER,Current,2022-05-12 11:40:54,2022-05-12 11:40:54,To GBP Rainy day,-0.75,0.00,GBP,COMPLETED,3922.93
CARD_PAYMENT,Current,2022-05-11 17:17:35,2022-05-12 12:00:26,Westport Wine,-24.95,0.00,GBP,COMPLETED,3897.98
CARD_PAYMENT,Current,2022-05-11 12:54:06,2022-05-12 12:12:16,Starbucks,-3.35,0.00,GBP,COMPLETED,3894.63
CARD_PAYMENT,Current,2022-05-11 14:22:13,2022-05-12 12:59:13,Robert Dyas,-21.07,0.00,GBP,COMPLETED,3873.56
CARD_PAYMENT,Current,2022-05-11 14:34:28,2022-05-12 13:26:13,Marugame Udon,-29.75,0.00,GBP,COMPLETED,3843.81
CARD_PAYMENT,Current,2022-05-11 06:23:19,2022-05-12 13:29:10,Are Airlines Representat,-100.93,0.00,GBP,COMPLETED,3742.88
TRANSFER,Current,2022-05-12 13:55:21,2022-05-12 13:55:21,To GBP Rainy day,-1.95,0.00,GBP,COMPLETED,3740.93
CARD_PAYMENT,Current,2022-05-12 01:45:13,2022-05-12 14:04:35,Transport for London,-4.20,0.00,GBP,COMPLETED,3736.73
TRANSFER,Current,2022-05-12 17:21:20,2022-05-12 17:21:20,To GBP Rainy day,-3.00,0.00,GBP,COMPLETED,3733.73
TRANSFER,Current,2022-05-12 17:30:37,2022-05-12 17:30:37,To GBP Rainy day,-0.03,0.00,GBP,COMPLETED,3733.70
TRANSFER,Current,2022-05-12 17:53:46,2022-05-12 17:53:46,To GBP Rainy day,-0.57,0.00,GBP,COMPLETED,3733.13
CARD_PAYMENT,Current,2022-05-11 12:08:41,2022-05-12 18:37:18,Apple,-4.99,0.00,GBP,COMPLETED,3728.14
TRANSFER,Current,2022-05-13 07:08:12,2022-05-13 07:08:12,To GBP Rainy day,-5.00,0.00,GBP,COMPLETED,3723.14
TRANSFER,Current,2022-05-13 09:47:57,2022-05-13 09:47:57,To GBP Rainy day,-1.95,0.00,GBP,COMPLETED,3721.19
TRANSFER,Current,2022-05-13 11:40:00,2022-05-13 11:40:00,To GBP Rainy day,-2.40,0.00,GBP,COMPLETED,3718.79
CARD_PAYMENT,Current,2022-05-12 17:30:36,2022-05-13 11:41:33,Waterstones,-9.99,0.00,GBP,COMPLETED,3708.80
CARD_PAYMENT,Current,2022-05-12 17:21:20,2022-05-13 11:56:12,Adam Grooming Atelier,-30.00,0.00,GBP,COMPLETED,3678.80
CARD_PAYMENT,Current,2022-05-12 10:48:52,2022-05-13 12:11:00,Starbucks,-3.35,0.00,GBP,COMPLETED,3675.45
CARD_PAYMENT,Current,2022-05-12 11:40:53,2022-05-13 12:13:22,Starbucks,-1.75,0.00,GBP,COMPLETED,3673.70
CARD_PAYMENT,Current,2022-05-12 13:55:20,2022-05-13 12:13:22,Starbucks,-3.35,0.00,GBP,COMPLETED,3670.35
CARD_PAYMENT,Current,2022-05-12 17:53:45,2022-05-13 13:37:59,Waitrose & Partners,-29.81,0.00,GBP,COMPLETED,3640.54
CARD_PAYMENT,Current,2022-05-12 09:50:57,2022-05-13 14:41:19,Sainsbury's,-5.25,0.00,GBP,COMPLETED,3635.29
TRANSFER,Current,2022-05-13 18:17:39,2022-05-13 18:17:39,To GBP Rainy day,-0.69,0.00,GBP,COMPLETED,3634.60
TRANSFER,Current,2022-05-13 18:21:40,2022-05-13 18:21:40,To GBP Rainy day,-1.20,0.00,GBP,COMPLETED,3633.40
TRANSFER,Current,2022-05-13 18:31:51,2022-05-13 18:31:51,To GBP Rainy day,-3.00,0.00,GBP,COMPLETED,3630.40
TRANSFER,Current,2022-05-13 18:54:30,2022-05-13 18:54:30,To GBP Rainy day,-1.50,0.00,GBP,COMPLETED,3628.90
TRANSFER,Current,2022-05-13 19:38:32,2022-05-13 19:38:32,To GBP Rainy day,-1.50,0.00,GBP,COMPLETED,3627.40
TRANSFER,Current,2022-05-13 21:06:27,2022-05-13 21:06:27,To GBP Rainy day,-2.07,0.00,GBP,COMPLETED,3625.33
TRANSFER,Current,2022-05-14 07:05:25,2022-05-14 07:05:25,To GBP Rainy day,-5.00,0.00,GBP,COMPLETED,3620.33
CARD_PAYMENT,Current,2022-05-13 09:47:42,2022-05-14 12:38:02,Starbucks,-3.35,0.00,GBP,COMPLETED,3616.98
CARD_PAYMENT,Current,2022-05-13 18:21:40,2022-05-14 13:16:36,Waitrose & Partners,-1.60,0.00,GBP,COMPLETED,3615.38
CARD_PAYMENT,Current,2022-05-13 18:17:38,2022-05-14 13:24:35,Robert Dyas,-22.77,0.00,GBP,COMPLETED,3592.61
CARD_PAYMENT,Current,2022-05-13 21:06:27,2022-05-14 14:28:33,Obica,-79.31,0.00,GBP,COMPLETED,3513.30
CARD_PAYMENT,Current,2022-05-13 11:40:00,2022-05-14 15:40:34,Marugame Udon,-14.20,0.00,GBP,COMPLETED,3499.10
TRANSFER,Current,2022-05-14 20:33:07,2022-05-14 20:33:07,To GBP Rainy day,-3.00,0.00,GBP,COMPLETED,3496.10
TRANSFER,Current,2022-05-14 22:13:51,2022-05-14 22:13:51,To GBP Rainy day,-3.00,0.00,GBP,COMPLETED,3493.10
FEE,Current,2022-05-15 00:59:17,2022-05-15 00:59:17,Premium plan fee,-72.00,0.00,GBP,COMPLETED,3421.10
TRANSFER,Current,2022-05-15 07:06:01,2022-05-15 07:06:01,To GBP Rainy day,-5.00,0.00,GBP,COMPLETED,3416.10
TRANSFER,Current,2022-05-15 08:38:01,2022-05-15 08:38:01,To GBP Rainy day,-3.00,0.00,GBP,COMPLETED,3413.10
CARD_PAYMENT,Current,2022-05-14 22:13:51,2022-05-15 11:05:10,Let's Do This,-21.00,0.00,GBP,COMPLETED,3392.10
CARD_PAYMENT,Current,2022-05-13 18:54:30,2022-05-15 12:17:31,No 35 Mackenzie Walk,-15.50,0.00,GBP,COMPLETED,3376.60
CARD_PAYMENT,Current,2022-05-13 19:38:31,2022-05-15 12:17:31,No 35 Mackenzie Walk,-15.50,0.00,GBP,COMPLETED,3361.10
CARD_PAYMENT,Current,2022-05-13 18:31:50,2022-05-15 12:17:31,No 35 Mackenzie Walk,-7.00,0.00,GBP,COMPLETED,3354.10
CARD_PAYMENT,Current,2022-05-14 20:33:07,2022-05-15 13:37:45,Sainsbury's,-12.00,0.00,GBP,COMPLETED,3342.10
TRANSFER,Current,2022-05-15 14:14:14,2022-05-15 14:14:14,To GBP Rainy day,-1.35,0.00,GBP,COMPLETED,3340.75
TRANSFER,Current,2022-05-15 17:33:30,2022-05-15 17:33:30,To GBP Rainy day,-2.85,0.00,GBP,COMPLETED,3337.90
TRANSFER,Current,2022-05-16 01:18:28,2022-05-16 01:18:28,To GBP Rainy day,-1.20,0.00,GBP,COMPLETED,3336.70
TRANSFER,Current,2022-05-16 07:22:11,2022-05-16 07:22:11,To GBP Rainy day,-5.00,0.00,GBP,COMPLETED,3331.70
TRANSFER,Current,2022-05-16 09:34:50,2022-05-16 09:34:50,To GBP Rainy day,-1.95,0.00,GBP,COMPLETED,3329.75
TRANSFER,Current,2022-05-16 10:36:21,2022-05-16 10:36:21,To GBP Rainy day,-1.95,0.00,GBP,COMPLETED,3327.80
CARD_PAYMENT,Current,2022-05-15 14:14:14,2022-05-16 12:59:14,Robert Dyas,-24.55,0.00,GBP,COMPLETED,3303.25
CARD_PAYMENT,Current,2022-05-15 08:38:00,2022-05-16 13:07:48,Santander Cycles,-2.00,0.00,GBP,COMPLETED,3301.25
CARD_PAYMENT,Current,2022-05-16 01:18:28,2022-05-16 14:03:41,Transport for London,-1.60,0.00,GBP,COMPLETED,3299.65
TRANSFER,Current,2022-05-16 15:55:16,2022-05-16 15:55:16,To GBP Rainy day,-1.80,0.00,GBP,COMPLETED,3297.85
TRANSFER,Current,2022-05-16 18:26:20,2022-05-16 18:26:20,To GBP Rainy day,-3.00,0.00,GBP,COMPLETED,3294.85
TRANSFER,Current,2022-05-16 18:48:53,2022-05-16 18:48:53,To GBP Rainy day,-1.20,0.00,GBP,COMPLETED,3293.65
TRANSFER,Current,2022-05-17 07:05:04,2022-05-17 07:05:04,To GBP Rainy day,-5.00,0.00,GBP,COMPLETED,3288.65
TRANSFER,Current,2022-05-17 09:54:45,2022-05-17 09:54:45,To GBP Rainy day,-1.95,0.00,GBP,COMPLETED,3286.70
CARD_PAYMENT,Current,2022-05-15 17:33:30,2022-05-17 10:02:19,Just Eat,-59.05,0.00,GBP,COMPLETED,3227.65
CARD_PAYMENT,Current,2022-05-16 09:34:49,2022-05-17 12:44:50,Starbucks,-3.35,0.00,GBP,COMPLETED,3224.30
CARD_PAYMENT,Current,2022-05-16 10:36:21,2022-05-17 12:46:15,Starbucks,-3.35,0.00,GBP,COMPLETED,3220.95
CARD_PAYMENT,Current,2022-05-16 18:48:52,2022-05-17 13:35:00,Riverside Supermarket,-1.60,0.00,GBP,COMPLETED,3219.35
CARD_PAYMENT,Current,2022-05-16 18:26:19,2022-05-17 13:39:50,Waitrose & Partners,-13.00,0.00,GBP,COMPLETED,3206.35
CARD_PAYMENT,Current,2022-05-16 15:55:15,2022-05-17 15:19:39,Marugame Udon,-12.40,0.00,GBP,COMPLETED,3193.95
TRANSFER,Current,2022-05-17 15:43:27,2022-05-17 15:43:27,From Mansur Kurmakaev,55.42,0.00,GBP,COMPLETED,3249.37
TRANSFER,Current,2022-05-17 18:20:25,2022-05-17 18:20:25,To GBP Rainy day,-0.06,0.00,GBP,COMPLETED,3249.31
TRANSFER,Current,2022-05-17 21:04:19,2022-05-17 21:04:19,To GBP Rainy day,-0.69,0.00,GBP,COMPLETED,3248.62
TRANSFER,Current,2022-05-18 01:45:48,2022-05-18 01:45:48,To GBP Rainy day,-1.50,0.00,GBP,COMPLETED,3247.12
TRANSFER,Current,2022-05-18 07:05:18,2022-05-18 07:05:18,To GBP Rainy day,-5.00,0.00,GBP,COMPLETED,3242.12
TRANSFER,Current,2022-05-18 09:43:00,2022-05-18 09:43:00,To GBP Rainy day,-0.45,0.00,GBP,COMPLETED,3241.67
TRANSFER,Current,2022-05-18 09:46:26,2022-05-18 09:46:26,To GBP Rainy day,-1.50,0.00,GBP,COMPLETED,3240.17
CARD_PAYMENT,Current,2022-05-17 18:20:24,2022-05-18 11:08:50,Boots,-8.98,0.00,GBP,COMPLETED,3231.19
TRANSFER,Current,2022-05-18 11:14:25,2022-05-18 11:14:25,To GBP Rainy day,-1.95,0.00,GBP,COMPLETED,3229.24
CARD_PAYMENT,Current,2022-05-17 09:54:44,2022-05-18 11:21:19,Starbucks,-3.35,0.00,GBP,COMPLETED,3225.89
CARD_PAYMENT,Current,2022-05-18 01:45:48,2022-05-18 13:47:10,Transport for London,-2.50,0.00,GBP,COMPLETED,3223.39
TRANSFER,Current,2022-05-18 15:23:39,2022-05-18 15:23:39,To GBP Rainy day,-1.65,0.00,GBP,COMPLETED,3221.74
TRANSFER,Current,2022-05-18 18:41:56,2022-05-18 18:41:56,To GBP Rainy day,-2.34,0.00,GBP,COMPLETED,3219.40
TRANSFER,Current,2022-05-18 18:47:11,2022-05-18 18:47:11,To GBP Rainy day,-0.03,0.00,GBP,COMPLETED,3219.37
TRANSFER,Current,2022-05-19 07:06:09,2022-05-19 07:06:09,To GBP Rainy day,-5.00,0.00,GBP,COMPLETED,3214.37
TRANSFER,Current,2022-05-19 10:35:23,2022-05-19 10:35:23,To GBP Rainy day,-2.10,0.00,GBP,COMPLETED,3212.27
TRANSFER,Current,2022-05-19 12:55:24,2022-05-19 12:55:24,To GBP Rainy day,-1.95,0.00,GBP,COMPLETED,3210.32
TRANSFER,Current,2022-05-19 13:21:39,2022-05-19 13:21:39,To GBP Rainy day,-1.50,0.00,GBP,COMPLETED,3208.82
TRANSFER,Current,2022-05-19 16:04:12,2022-05-19 16:04:12,To GBP Rainy day,-2.94,0.00,GBP,COMPLETED,3205.88
CARD_PAYMENT,Current,2022-05-17 21:04:19,2022-05-19 16:18:34,Just Eat,-45.77,0.00,GBP,COMPLETED,3160.11
CARD_PAYMENT,Current,2022-05-18 09:43:00,2022-05-19 17:18:55,The Royal Society,-4.85,0.00,GBP,COMPLETED,3155.26
TRANSFER,Current,2022-05-19 18:36:52,2022-05-19 18:36:52,To GBP Rainy day,-2.10,0.00,GBP,COMPLETED,3153.16
TRANSFER,Current,2022-05-19 19:02:43,2022-05-19 19:02:43,To GBP Rainy day,-1.20,0.00,GBP,COMPLETED,3151.96
CARD_PAYMENT,Current,2022-05-18 11:14:24,2022-05-19 19:48:44,Starbucks,-3.35,0.00,GBP,COMPLETED,3148.61
TRANSFER,Current,2022-05-19 21:11:28,2022-05-19 21:11:28,To GBP Rainy day,-1.98,0.00,GBP,COMPLETED,3146.63
CARD_PAYMENT,Current,2022-05-18 18:47:10,2022-05-19 21:15:12,Robert Dyas,-9.99,0.00,GBP,COMPLETED,3136.64
CARD_PAYMENT,Current,2022-05-18 18:41:56,2022-05-19 21:20:48,Waitrose & Partners,-30.22,0.00,GBP,COMPLETED,3106.42
TRANSFER,Current,2022-05-19 21:34:36,2022-05-19 21:34:36,To GBP Rainy day,-1.98,0.00,GBP,COMPLETED,3104.44
TRANSFER,Current,2022-05-19 22:47:57,2022-05-19 22:47:57,To GBP Rainy day,-3.00,0.00,GBP,COMPLETED,3101.44
CARD_PAYMENT,Current,2022-05-18 15:23:39,2022-05-19 23:01:10,Market Halls,-14.45,0.00,GBP,COMPLETED,3086.99
CARD_PAYMENT,Current,2022-05-18 09:46:26,2022-05-20 00:26:36,The Royal Foundation,-27.50,0.00,GBP,COMPLETED,3059.49
TRANSFER,Current,2022-05-20 07:08:33,2022-05-20 07:08:33,To GBP Rainy day,-5.00,0.00,GBP,COMPLETED,3054.49
TRANSFER,Current,2022-05-20 10:39:18,2022-05-20 10:39:18,To GBP Rainy day,-1.95,0.00,GBP,COMPLETED,3052.54
TRANSFER,Current,2022-05-20 11:08:44,2022-05-20 11:08:44,To GBP Rainy day,-2.43,0.00,GBP,COMPLETED,3050.11
TRANSFER,Current,2022-05-20 11:43:36,2022-05-20 11:43:36,To GBP Rainy day,-2.70,0.00,GBP,COMPLETED,3047.41
TRANSFER,Current,2022-05-20 18:09:12,2022-05-20 18:09:12,To GBP Rainy day,-2.70,0.00,GBP,COMPLETED,3044.71
TRANSFER,Current,2022-05-20 21:43:12,2022-05-20 21:43:12,To GBP Rainy day,-0.03,0.00,GBP,COMPLETED,3044.68
CARD_PAYMENT,Current,2022-05-19 13:21:38,2022-05-21 02:01:28,Badiani Limite,-5.50,0.00,GBP,COMPLETED,3039.18
CARD_PAYMENT,Current,2022-05-19 10:35:22,2022-05-21 03:44:58,Starbucks,-8.30,0.00,GBP,COMPLETED,3030.88
CARD_PAYMENT,Current,2022-05-19 18:36:52,2022-05-21 04:33:35,Waitrose & Partners,-33.30,0.00,GBP,COMPLETED,2997.58
CARD_PAYMENT,Current,2022-05-19 22:47:57,2022-05-21 04:58:40,EE,-27.00,0.00,GBP,COMPLETED,2970.58
CARD_PAYMENT,Current,2022-05-19 19:02:43,2022-05-21 05:00:19,Riverside Supermarket,-1.60,0.00,GBP,COMPLETED,2968.98
CARD_PAYMENT,Current,2022-05-19 12:55:24,2022-05-21 05:38:37,Market Halls,-19.35,0.00,GBP,COMPLETED,2949.63
TRANSFER,Current,2022-05-21 07:05:30,2022-05-21 07:05:30,To GBP Rainy day,-5.00,0.00,GBP,COMPLETED,2944.63
CARD_PAYMENT,Current,2022-05-19 16:04:12,2022-05-21 07:24:10,Co-op,-35.02,0.00,GBP,COMPLETED,2909.61
TRANSFER,Current,2022-05-21 19:34:59,2022-05-21 19:34:59,To GBP Rainy day,-0.15,0.00,GBP,COMPLETED,2909.46
CARD_PAYMENT,Current,2022-05-19 21:34:36,2022-05-22 03:04:34,The Prospect of Whitby,-11.34,0.00,GBP,COMPLETED,2898.12
CARD_PAYMENT,Current,2022-05-19 21:11:28,2022-05-22 03:04:34,The Prospect of Whitby,-11.34,0.00,GBP,COMPLETED,2886.78
TRANSFER,Current,2022-05-22 03:17:15,2022-05-22 03:17:15,To GBP Rainy day,-0.03,0.00,GBP,COMPLETED,2886.75
CARD_PAYMENT,Current,2022-05-20 10:39:18,2022-05-22 03:21:58,Starbucks,-3.35,0.00,GBP,COMPLETED,2883.40
CARD_PAYMENT,Current,2022-05-20 11:08:37,2022-05-22 03:54:46,Waitrose,-221.19,0.00,GBP,COMPLETED,2662.21
CARD_PAYMENT,Current,2022-05-20 18:09:11,2022-05-22 04:00:42,Waitrose & Partners,-29.10,0.00,GBP,COMPLETED,2633.11
CARD_PAYMENT,Current,2022-05-20 11:43:35,2022-05-22 06:38:53,Marugame Udon,-15.10,0.00,GBP,COMPLETED,2618.01
TRANSFER,Current,2022-05-22 07:05:19,2022-05-22 07:05:19,To GBP Rainy day,-5.00,0.00,GBP,COMPLETED,2613.01
TRANSFER,Current,2022-05-22 14:16:21,2022-05-22 14:16:21,To GBP Rainy day,-2.25,0.00,GBP,COMPLETED,2610.76
CARD_PAYMENT,Current,2022-05-20 21:43:12,2022-05-22 14:57:21,Apple,-10.99,0.00,GBP,COMPLETED,2599.77
TRANSFER,Current,2022-05-22 16:04:38,2022-05-22 16:04:38,To GBP Rainy day,-0.90,0.00,GBP,COMPLETED,2598.87
TRANSFER,Current,2022-05-22 16:05:33,2022-05-22 16:05:33,To GBP Rainy day,-2.40,0.00,GBP,COMPLETED,2596.47
TRANSFER,Current,2022-05-22 16:23:45,2022-05-22 16:23:45,To GBP Rainy day,-0.30,0.00,GBP,COMPLETED,2596.17
TRANSFER,Current,2022-05-22 22:51:12,2022-05-22 22:51:12,To GBP Rainy day,-3.00,0.00,GBP,COMPLETED,2593.17
TRANSFER,Current,2022-05-23 01:20:35,2022-05-23 01:20:35,To GBP Rainy day,-0.45,0.00,GBP,COMPLETED,2592.72
CARD_PAYMENT,Current,2022-05-21 19:34:59,2022-05-23 05:58:32,Sainsbury's,-20.95,0.00,GBP,COMPLETED,2571.77
TRANSFER,Current,2022-05-23 07:22:23,2022-05-23 07:22:23,To GBP Rainy day,-5.00,0.00,GBP,COMPLETED,2566.77
TRANSFER,Current,2022-05-23 10:50:21,2022-05-23 10:50:21,To GBP Rainy day,-1.95,0.00,GBP,COMPLETED,2564.82
TRANSFER,Current,2022-05-23 13:08:08,2022-05-23 13:08:08,To GBP Rainy day,-0.15,0.00,GBP,COMPLETED,2564.67
TRANSFER,Current,2022-05-23 13:33:09,2022-05-23 13:33:09,To GBP Rainy day,-1.50,0.00,GBP,COMPLETED,2563.17
TRANSFER,Current,2022-05-23 15:49:14,2022-05-23 15:49:14,To GBP Rainy day,-0.15,0.00,GBP,COMPLETED,2563.02
TRANSFER,Current,2022-05-23 18:36:55,2022-05-23 18:36:55,To GBP Rainy day,-2.46,0.00,GBP,COMPLETED,2560.56
TRANSFER,Current,2022-05-23 18:50:01,2022-05-23 18:50:01,To GBP Rainy day,-1.50,0.00,GBP,COMPLETED,2559.06
TRANSFER,Current,2022-05-23 19:09:08,2022-05-23 19:09:08,To GBP Rainy day,-2.70,0.00,GBP,COMPLETED,2556.36
TRANSFER,Current,2022-05-23 21:39:34,2022-05-23 21:39:34,To GBP Rainy day,-1.83,0.00,GBP,COMPLETED,2554.53
CARD_PAYMENT,Current,2022-05-23 21:41:59,,WHEELY,-18.00,0.00,GBP,REVERTED,
TRANSFER,Current,2022-05-23 21:41:59,2022-05-23 21:41:59,To GBP Rainy day,-3.00,0.00,GBP,COMPLETED,2551.53
CARD_PAYMENT,Current,2022-05-22 14:16:21,2022-05-23 22:57:41,The Royal Society,-18.25,0.00,GBP,COMPLETED,2533.28
CARD_PAYMENT,Current,2022-05-22 16:23:45,2022-05-23 23:10:37,Snog Frozen Yogurt,-9.90,0.00,GBP,COMPLETED,2523.38
CARD_PAYMENT,Current,2022-05-22 16:05:33,2022-05-23 23:18:06,Chinatown Bakery,-2.20,0.00,GBP,COMPLETED,2521.18
CARD_PAYMENT,Current,2022-05-22 16:04:38,2022-05-23 23:18:06,Chinatown Bakery,-6.70,0.00,GBP,COMPLETED,2514.48
CARD_PAYMENT,Current,2022-05-22 22:51:11,2022-05-24 00:16:26,EE,-18.00,0.00,GBP,COMPLETED,2496.48
CARD_PAYMENT,Current,2022-05-23 01:20:35,2022-05-24 01:53:06,Transport for London,-6.85,0.00,GBP,COMPLETED,2489.63
TRANSFER,Current,2022-05-24 04:51:39,2022-05-24 04:51:39,To GBP Rainy day,-2.70,0.00,GBP,COMPLETED,2486.93
CARD_PAYMENT,Current,2022-05-22 03:17:15,2022-05-24 05:41:38,Apple,-6.99,0.00,GBP,COMPLETED,2479.94
TRANSFER,Current,2022-05-24 07:04:55,2022-05-24 07:04:55,To GBP Rainy day,-5.00,0.00,GBP,COMPLETED,2474.94
TRANSFER,Current,2022-05-24 10:12:24,2022-05-24 10:12:24,To GBP Rainy day,-1.95,0.00,GBP,COMPLETED,2472.99
TRANSFER,Current,2022-05-24 11:44:59,2022-05-24 11:44:59,To GBP Rainy day,-0.90,0.00,GBP,COMPLETED,2472.09
CARD_PAYMENT,Current,2022-05-23 13:33:08,2022-05-24 14:07:32,Badiani Limite,-5.50,0.00,GBP,COMPLETED,2466.59
CARD_PAYMENT,Current,2022-05-23 15:49:14,2022-05-24 15:07:37,Shutters,-2.95,0.00,GBP,COMPLETED,2463.64
CARD_PAYMENT,Current,2022-05-23 10:50:21,2022-05-24 15:50:49,Starbucks,-3.35,0.00,GBP,COMPLETED,2460.29
CARD_PAYMENT,Current,2022-05-23 18:36:55,2022-05-24 16:30:49,Waitrose & Partners,-40.18,0.00,GBP,COMPLETED,2420.11
CARD_PAYMENT,Current,2022-05-23 13:08:07,2022-05-24 16:31:17,Seoul Bird,-10.95,0.00,GBP,COMPLETED,2409.16
TRANSFER,Current,2022-05-24 19:09:03,2022-05-24 19:09:03,To GBP Rainy day,-1.20,0.00,GBP,COMPLETED,2407.96
TRANSFER,Current,2022-05-24 19:20:39,2022-05-24 19:20:39,To GBP Rainy day,-3.00,0.00,GBP,COMPLETED,2404.96
TRANSFER,Current,2022-05-24 19:44:43,2022-05-24 19:44:43,To GBP Rainy day,-1.20,0.00,GBP,COMPLETED,2403.76
TRANSFER,Current,2022-05-25 07:05:35,2022-05-25 07:05:35,To GBP Rainy day,-5.00,0.00,GBP,COMPLETED,2398.76
CARD_PAYMENT,Current,2022-05-23 21:39:34,2022-05-25 10:14:06,Trainline,-21.39,0.00,GBP,COMPLETED,2377.37
CARD_PAYMENT,Current,2022-05-24 04:51:39,2022-05-25 10:25:24,WHEELY,-24.10,0.00,GBP,COMPLETED,2353.27
CARD_PAYMENT,Current,2022-05-23 18:50:01,2022-05-25 10:33:59,No 35 Mackenzie Walk,-15.50,0.00,GBP,COMPLETED,2337.77
CARD_PAYMENT,Current,2022-05-23 19:09:08,2022-05-25 10:33:59,No 35 Mackenzie Walk,-20.10,0.00,GBP,COMPLETED,2317.67
CARD_PAYMENT,Current,2022-05-24 10:12:24,2022-05-25 11:02:44,Starbucks,-3.35,0.00,GBP,COMPLETED,2314.32
TRANSFER,Current,2022-05-25 11:11:47,2022-05-25 11:11:47,To GBP Rainy day,-2.10,0.00,GBP,COMPLETED,2312.22
CARD_PAYMENT,Current,2022-05-24 19:44:43,2022-05-25 11:43:08,Riverside Supermarket,-1.60,0.00,GBP,COMPLETED,2310.62
CARD_PAYMENT,Current,2022-05-24 19:09:03,2022-05-25 11:46:21,Waitrose & Partners,-10.60,0.00,GBP,COMPLETED,2300.02
TRANSFER,Current,2022-05-25 12:51:53,2022-05-25 12:51:53,To GBP Rainy day,-3.00,0.00,GBP,COMPLETED,2297.02
CARD_PAYMENT,Current,2022-05-24 11:44:59,2022-05-25 12:52:28,Marugame Udon,-13.70,0.00,GBP,COMPLETED,2283.32
TRANSFER,Current,2022-05-25 18:27:05,2022-05-25 18:27:05,To GBP Rainy day,-1.05,0.00,GBP,COMPLETED,2282.27
TRANSFER,Current,2022-05-25 18:35:28,2022-05-25 18:35:28,To GBP Rainy day,-3.00,0.00,GBP,COMPLETED,2279.27
TRANSFER,Current,2022-05-25 19:01:03,2022-05-25 19:01:03,To GBP Rainy day,-1.20,0.00,GBP,COMPLETED,2278.07
TRANSFER,Current,2022-05-26 07:06:35,2022-05-26 07:06:35,To GBP Rainy day,-5.00,0.00,GBP,COMPLETED,2273.07
CARD_PAYMENT,Current,2022-05-25 12:51:53,2022-05-26 09:33:30,Marugame Udon,-8.00,0.00,GBP,COMPLETED,2265.07
CARD_PAYMENT,Current,2022-05-24 19:20:39,2022-05-26 11:28:47,No 35 Mackenzie Walk,-7.00,0.00,GBP,COMPLETED,2258.07
TRANSFER,Current,2022-05-26 11:34:12,2022-05-26 11:34:12,To GBP Rainy day,-1.95,0.00,GBP,COMPLETED,2256.12
CARD_PAYMENT,Current,2022-05-25 11:11:47,2022-05-26 12:10:04,Starbucks,-3.30,0.00,GBP,COMPLETED,2252.82
CARD_PAYMENT,Current,2022-05-25 19:01:03,2022-05-26 13:00:17,Riverside Supermarket,-1.60,0.00,GBP,COMPLETED,2251.22
CARD_PAYMENT,Current,2022-05-25 18:27:05,2022-05-26 13:24:23,Waitrose & Partners,-41.65,0.00,GBP,COMPLETED,2209.57
TRANSFER,Current,2022-05-26 14:23:14,2022-05-26 14:23:14,To GBP Rainy day,-2.70,0.00,GBP,COMPLETED,2206.87
TRANSFER,Current,2022-05-26 21:46:28,2022-05-26 21:46:28,To GBP Rainy day,-2.10,0.00,GBP,COMPLETED,2204.77
TRANSFER,Current,2022-05-27 01:39:46,2022-05-27 01:39:46,To GBP Rainy day,-2.40,0.00,GBP,COMPLETED,2202.37
TRANSFER,Current,2022-05-27 07:08:40,2022-05-27 07:08:40,To GBP Rainy day,-5.00,0.00,GBP,COMPLETED,2197.37
CARD_PAYMENT,Current,2022-05-25 18:35:28,2022-05-27 10:40:25,No 35 Mackenzie Walk,-7.00,0.00,GBP,COMPLETED,2190.37
TRANSFER,Current,2022-05-27 10:59:38,2022-05-27 10:59:38,To GBP Rainy day,-2.10,0.00,GBP,COMPLETED,2188.27
CARD_PAYMENT,Current,2022-05-26 11:34:12,2022-05-27 11:14:59,Starbucks,-3.35,0.00,GBP,COMPLETED,2184.92
TRANSFER,Current,2022-05-27 12:12:46,2022-05-27 12:12:46,To GBP Rainy day,-1.95,0.00,GBP,COMPLETED,2182.97
CARD_PAYMENT,Current,2022-05-26 14:23:14,2022-05-27 13:40:01,Hazev Restaurant,-7.10,0.00,GBP,COMPLETED,2175.87
CARD_PAYMENT,Current,2022-05-27 01:39:46,2022-05-27 13:53:35,Transport for London,-5.20,0.00,GBP,COMPLETED,2170.67
CARD_PAYMENT,Current,2022-05-26 21:46:28,2022-05-27 14:16:00,Ye Olde Watling,-6.30,0.00,GBP,COMPLETED,2164.37
TRANSFER,Current,2022-05-27 14:23:43,2022-05-27 14:23:43,To GBP Rainy day,-0.90,0.00,GBP,COMPLETED,2163.47
TRANSFER,Current,2022-05-27 18:06:54,2022-05-27 18:06:54,To GBP Rainy day,-0.90,0.00,GBP,COMPLETED,2162.57
TRANSFER,Current,2022-05-27 19:37:23,2022-05-27 19:37:23,To GBP Rainy day,-0.60,0.00,GBP,COMPLETED,2161.97
TRANSFER,Current,2022-05-28 07:06:03,2022-05-28 07:06:03,To GBP Rainy day,-5.00,0.00,GBP,COMPLETED,2156.97
CARD_PAYMENT,Current,2022-05-27 10:59:37,2022-05-28 10:28:44,Starbucks,-3.30,0.00,GBP,COMPLETED,2153.67
CARD_PAYMENT,Current,2022-05-27 12:12:46,2022-05-28 10:28:44,Starbucks,-3.35,0.00,GBP,COMPLETED,2150.32
CARD_PAYMENT,Current,2022-05-27 19:37:23,2022-05-28 10:55:40,Waitrose & Partners,-36.80,0.00,GBP,COMPLETED,2113.52
TRANSFER,Current,2022-05-28 14:40:05,2022-05-28 14:40:05,To GBP Rainy day,-0.06,0.00,GBP,COMPLETED,2113.46
CARD_PAYMENT,Current,2022-05-27 18:06:54,2022-05-28 22:33:05,Trainline,-20.70,0.00,GBP,COMPLETED,2092.76
TRANSFER,Current,2022-05-29 07:05:35,2022-05-29 07:05:35,To GBP Rainy day,-5.00,0.00,GBP,COMPLETED,2087.76
CARD_PAYMENT,Current,2022-05-28 14:40:02,2022-05-29 10:02:28,Sainsbury's,-20.98,0.00,GBP,COMPLETED,2066.78
CARD_PAYMENT,Current,2022-05-27 14:23:43,2022-05-29 10:17:39,Marugame Udon,-11.70,0.00,GBP,COMPLETED,2055.08
TRANSFER,Current,2022-05-29 10:37:41,2022-05-29 10:37:41,To GBP,900.00,0.00,GBP,COMPLETED,2955.08
TRANSFER,Current,2022-05-29 10:39:37,2022-05-29 10:39:37,To GBP,2000.00,0.00,GBP,COMPLETED,4955.08
TRANSFER,Current,2022-05-29 13:30:36,2022-05-29 13:30:36,To GBP Rainy day,-0.03,0.00,GBP,COMPLETED,4955.05
TRANSFER,Current,2022-05-29 19:55:30,2022-05-29 19:55:30,To GBP Rainy day,-0.12,0.00,GBP,COMPLETED,4954.93
TRANSFER,Current,2022-05-29 21:33:30,2022-05-29 21:33:30,To GBP Rainy day,-1.80,0.00,GBP,COMPLETED,4953.13
TRANSFER,Current,2022-05-30 01:19:38,2022-05-30 01:19:38,To GBP Rainy day,-2.70,0.00,GBP,COMPLETED,4950.43
TRANSFER,Current,2022-05-30 03:08:44,2022-05-30 03:08:44,To GBP Rainy day,-3.00,0.00,GBP,COMPLETED,4947.43
TRANSFER,Current,2022-05-30 04:07:32,2022-05-30 04:07:32,To GBP Rainy day,-0.03,0.00,GBP,COMPLETED,4947.40
TRANSFER,Current,2022-05-30 07:23:18,2022-05-30 07:23:18,To GBP Rainy day,-5.00,0.00,GBP,COMPLETED,4942.40
TRANSFER,Current,2022-05-30 08:19:07,2022-05-30 08:19:07,To GBP Rainy day,-1.95,0.00,GBP,COMPLETED,4940.45
TRANSFER,Current,2022-05-30 09:01:56,2022-05-30 09:01:58,To Holly Michael,-2450.00,0.00,GBP,COMPLETED,2490.45
TRANSFER,Current,2022-05-30 09:45:28,2022-05-30 09:45:28,To GBP Rainy day,-1.95,0.00,GBP,COMPLETED,2488.50
CARD_PAYMENT,Current,2022-05-29 19:55:30,2022-05-30 10:14:08,Nisa,-19.96,0.00,GBP,COMPLETED,2468.54
CARD_PAYMENT,Current,2022-05-29 13:30:35,2022-05-30 11:08:01,Amazon Prime,-7.99,0.00,GBP,COMPLETED,2460.55
TRANSFER,Current,2022-05-30 11:42:13,2022-05-30 11:42:13,To GBP Rainy day,-0.75,0.00,GBP,COMPLETED,2459.80
CARD_PAYMENT,Current,2022-05-29 21:33:30,2022-05-30 14:02:10,Sainsbury's,-10.40,0.00,GBP,COMPLETED,2449.40
CARD_PAYMENT,Current,2022-05-30 01:19:38,2022-05-30 14:09:15,Transport for London,-4.10,0.00,GBP,COMPLETED,2445.30
CARD_PAYMENT,Current,2022-05-30 04:07:32,2022-05-30 14:09:24,Netflix,-10.99,0.00,GBP,COMPLETED,2434.31
TRANSFER,Current,2022-05-30 14:40:15,2022-05-30 14:40:15,To GBP Rainy day,-0.03,0.00,GBP,COMPLETED,2434.28
TRANSFER,Current,2022-05-30 19:16:46,2022-05-30 19:16:46,To GBP Rainy day,-2.04,0.00,GBP,COMPLETED,2432.24
TRANSFER,Current,2022-05-31 01:00:00,2022-05-31 01:01:14,To Virgin Active,-139.99,0.00,GBP,COMPLETED,2292.25
TRANSFER,Current,2022-05-31 07:05:56,2022-05-31 07:05:56,To GBP Rainy day,-5.00,0.00,GBP,COMPLETED,2287.25
CARD_PAYMENT,Current,2022-05-30 11:42:12,2022-05-31 09:59:40,Marugame Udon,-12.75,0.00,GBP,COMPLETED,2274.50
CARD_PAYMENT,Current,2022-05-30 19:16:46,2022-05-31 10:13:20,Waitrose & Partners,-19.32,0.00,GBP,COMPLETED,2255.18
TRANSFER,Current,2022-05-31 10:15:43,2022-05-31 10:15:43,To GBP Rainy day,-1.95,0.00,GBP,COMPLETED,2253.23
TRANSFER,Current,2022-05-31 11:32:34,2022-05-31 11:32:34,To GBP Rainy day,-1.95,0.00,GBP,COMPLETED,2251.28
TRANSFER,Current,2022-05-31 14:53:54,2022-05-31 14:53:54,To GBP Rainy day,-2.70,0.00,GBP,COMPLETED,2248.58
CARD_PAYMENT,Current,2022-05-30 14:40:15,2022-05-31 15:27:49,News On The Wharf,-7.99,0.00,GBP,COMPLETED,2240.59
CARD_PAYMENT,Current,2022-05-30 03:08:44,2022-05-31 15:51:51,Loqbox,-50.00,0.00,GBP,COMPLETED,2190.59
CARD_PAYMENT,Current,2022-05-30 09:45:27,2022-05-31 16:49:42,Starbucks,-3.35,0.00,GBP,COMPLETED,2187.24
CARD_PAYMENT,Current,2022-05-30 08:19:07,2022-05-31 16:49:52,Starbucks,-3.35,0.00,GBP,COMPLETED,2183.89
TRANSFER,Current,2022-05-31 18:07:28,2022-05-31 18:07:28,To GBP Rainy day,-1.50,0.00,GBP,COMPLETED,2182.39
TRANSFER,Current,2022-05-31 18:14:02,2022-05-31 18:14:02,To GBP Rainy day,-0.24,0.00,GBP,COMPLETED,2182.15
TRANSFER,Current,2022-05-31 19:24:23,2022-05-31 19:24:23,To GBP Rainy day,-1.98,0.00,GBP,COMPLETED,2180.17
TRANSFER,Current,2022-05-31 19:40:23,2022-05-31 19:40:23,To GBP Rainy day,-1.98,0.00,GBP,COMPLETED,2178.19
TRANSFER,Current,2022-05-31 20:05:41,2022-05-31 20:05:41,To GBP Rainy day,-0.51,0.00,GBP,COMPLETED,2177.68
TRANSFER,Current,2022-05-31 22:08:19,2022-05-31 22:08:19,To GBP Rainy day,-2.10,0.00,GBP,COMPLETED,2175.58
TRANSFER,Current,2022-05-31 22:45:17,2022-05-31 22:45:17,To GBP Rainy day,-0.96,0.00,GBP,COMPLETED,2174.62
TRANSFER,Current,2022-06-01 07:10:21,2022-06-01 07:10:21,To GBP Rainy day,-5.00,0.00,GBP,COMPLETED,2169.62
CARD_PAYMENT,Current,2022-05-31 18:07:27,2022-06-01 10:22:50,Boots,-35.50,0.00,GBP,COMPLETED,2134.12
CARD_PAYMENT,Current,2022-05-31 10:15:43,2022-06-01 11:16:57,Starbucks,-3.35,0.00,GBP,COMPLETED,2130.77
CARD_PAYMENT,Current,2022-05-31 11:32:34,2022-06-01 11:17:07,Starbucks,-3.35,0.00,GBP,COMPLETED,2127.42
TRANSFER,Current,2022-06-01 11:22:33,2022-06-01 11:22:33,To GBP Rainy day,-1.95,0.00,GBP,COMPLETED,2125.47
TRANSFER,Current,2022-06-01 11:57:29,2022-06-01 11:57:30,From WECTORY LTD,6247.55,0.00,GBP,COMPLETED,8373.02
TRANSFER,Current,2022-06-01 12:36:53,2022-06-01 12:36:54,To GBP Rainy day,-1.65,0.00,GBP,COMPLETED,8371.37
CARD_PAYMENT,Current,2022-05-31 14:53:54,2022-06-01 13:22:32,Waitrose & Partners,-21.10,0.00,GBP,COMPLETED,8350.27
TRANSFER,Current,2022-06-01 14:12:17,2022-06-01 14:12:17,To GBP Rainy day,-0.03,0.00,GBP,COMPLETED,8350.24
TRANSFER,Current,2022-06-01 14:23:24,2022-06-01 14:23:24,To GBP Rainy day,-0.03,0.00,GBP,COMPLETED,8350.21
TRANSFER,Current,2022-06-01 15:47:16,2022-06-01 15:47:16,To GBP Rainy day,-1.95,0.00,GBP,COMPLETED,8348.26
TRANSFER,Current,2022-06-01 19:47:49,2022-06-01 19:47:49,To GBP Rainy day,-3.00,0.00,GBP,COMPLETED,8345.26
TRANSFER,Current,2022-06-01 19:52:41,2022-06-01 19:52:41,To GBP Rainy day,-0.60,0.00,GBP,COMPLETED,8344.66
TRANSFER,Current,2022-06-02 07:06:49,2022-06-02 07:06:49,To GBP Rainy day,-5.00,0.00,GBP,COMPLETED,8339.66
TRANSFER,Current,2022-06-02 09:01:58,2022-06-02 09:01:58,To Aleksandra Balabanova,-600.00,0.00,GBP,COMPLETED,7739.66
TRANSFER,Current,2022-06-02 09:01:58,2022-06-02 09:01:58,To Natalia Balabanova,-2000.00,0.00,GBP,COMPLETED,5739.66
TRANSFER,Current,2022-06-02 10:15:55,2022-06-02 10:15:55,To GBP Rainy day,-1.95,0.00,GBP,COMPLETED,5737.71
CARD_PAYMENT,Current,2022-05-31 22:08:18,2022-06-02 11:33:07,The Prospect of Whitby,-13.30,0.00,GBP,COMPLETED,5724.41
CARD_PAYMENT,Current,2022-05-31 22:45:17,2022-06-02 11:33:08,The Prospect of Whitby,-22.68,0.00,GBP,COMPLETED,5701.73
CARD_PAYMENT,Current,2022-05-31 19:40:23,2022-06-02 11:33:08,The Prospect of Whitby,-11.34,0.00,GBP,COMPLETED,5690.39
CARD_PAYMENT,Current,2022-05-31 19:24:23,2022-06-02 11:33:08,The Prospect of Whitby,-11.34,0.00,GBP,COMPLETED,5679.05
CARD_PAYMENT,Current,2022-05-31 20:05:41,2022-06-02 11:33:08,The Prospect of Whitby,-25.83,0.00,GBP,COMPLETED,5653.22
CARD_PAYMENT,Current,2022-05-31 18:14:02,2022-06-02 12:26:35,Holland & Barrett,-17.92,0.00,GBP,COMPLETED,5635.30
CARD_PAYMENT,Current,2022-06-01 14:23:13,2022-06-02 13:09:36,News On The Wharf,-5.99,0.00,GBP,COMPLETED,5629.31
CARD_PAYMENT,Current,2022-06-01 11:22:33,2022-06-02 13:37:00,Starbucks,-3.35,0.00,GBP,COMPLETED,5625.96
TRANSFER,Current,2022-06-02 13:55:32,2022-06-02 13:55:32,To GBP Rainy day,-2.43,0.00,GBP,COMPLETED,5623.53
CARD_PAYMENT,Current,2022-06-01 14:12:17,2022-06-02 14:05:36,Waitrose & Partners,-12.99,0.00,GBP,COMPLETED,5610.54
CARD_PAYMENT,Current,2022-06-01 15:47:16,2022-06-02 14:38:58,Canary Wharf,-2.35,0.00,GBP,COMPLETED,5608.19
TRANSFER,Current,2022-06-02 15:31:00,2022-06-02 15:31:00,To GBP Rainy day,-3.00,0.00,GBP,COMPLETED,5605.19
CARD_PAYMENT,Current,2022-06-01 19:47:48,2022-06-02 15:57:42,Sainsbury's,-34.00,0.00,GBP,COMPLETED,5571.19
CARD_PAYMENT,Current,2022-06-01 19:52:41,2022-06-02 15:58:03,Sainsbury's,-3.80,0.00,GBP,COMPLETED,5567.39
TRANSFER,Current,2022-06-02 17:55:57,2022-06-02 17:55:57,To GBP Rainy day,-0.03,0.00,GBP,COMPLETED,5567.36
TRANSFER,Current,2022-06-03 01:29:13,2022-06-03 01:29:13,To GBP Rainy day,-2.40,0.00,GBP,COMPLETED,5564.96
TRANSFER,Current,2022-06-03 07:08:52,2022-06-03 07:08:52,To GBP Rainy day,-5.00,0.00,GBP,COMPLETED,5559.96
CARD_PAYMENT,Current,2022-06-02 10:15:54,2022-06-03 10:48:41,Starbucks,-3.35,0.00,GBP,COMPLETED,5556.61
CARD_PAYMENT,Current,2022-06-02 15:31:00,2022-06-03 11:26:17,Waitrose & Partners,-6.00,0.00,GBP,COMPLETED,5550.61
CARD_PAYMENT,Current,2022-06-02 17:55:52,2022-06-03 11:26:17,Waitrose & Partners,-29.99,0.00,GBP,COMPLETED,5520.62
TRANSFER,Current,2022-06-03 12:30:45,2022-06-03 12:30:45,To GBP Rainy day,-2.55,0.00,GBP,COMPLETED,5518.07
CARD_PAYMENT,Current,2022-06-02 13:55:32,2022-06-03 13:10:44,Notes,-20.19,0.00,GBP,COMPLETED,5497.88
CARD_PAYMENT,Current,2022-06-03 01:29:11,2022-06-03 13:24:18,Transport for London,-5.20,0.00,GBP,COMPLETED,5492.68
TRANSFER,Current,2022-06-03 18:05:05,2022-06-03 18:05:05,To GBP,16650.00,0.00,GBP,COMPLETED,22142.68
EXCHANGE,Current,2022-06-03 18:06:02,2022-06-03 18:06:02,Exchanged to EUR,-16650.00,0.00,GBP,COMPLETED,5492.68
TRANSFER,Current,2022-06-03 20:02:47,2022-06-03 20:02:47,To GBP Rainy day,-1.20,0.00,GBP,COMPLETED,5491.48
TRANSFER,Current,2022-06-03 20:20:51,2022-06-03 20:20:51,To GBP Rainy day,-2.40,0.00,GBP,COMPLETED,5489.08
CARD_PAYMENT,Current,2022-06-01 12:36:53,2022-06-03 21:30:54,Marugame Udon,-12.45,0.00,GBP,COMPLETED,5476.63
TRANSFER,Current,2022-06-04 07:05:43,2022-06-04 07:05:43,To GBP Rainy day,-5.00,0.00,GBP,COMPLETED,5471.63
TRANSFER,Current,2022-06-04 10:16:04,2022-06-04 10:16:04,To GBP Rainy day,-1.95,0.00,GBP,COMPLETED,5469.68
TRANSFER,Current,2022-06-04 10:56:28,2022-06-04 10:56:28,To GBP Rainy day,-1.05,0.00,GBP,COMPLETED,5468.63
TRANSFER,Current,2022-06-04 11:01:55,2022-06-04 11:01:55,To GBP Rainy day,-0.06,0.00,GBP,COMPLETED,5468.57
TRANSFER,Current,2022-06-04 11:57:11,2022-06-04 11:57:11,To GBP Rainy day,-0.60,0.00,GBP,COMPLETED,5467.97
CARD_PAYMENT,Current,2022-06-03 20:20:51,2022-06-04 12:21:17,Hazev Restaurant,-7.20,0.00,GBP,COMPLETED,5460.77
CARD_PAYMENT,Current,2022-06-03 20:02:47,2022-06-04 12:21:17,Hazev Restaurant,-30.60,0.00,GBP,COMPLETED,5430.17
CARD_PAYMENT,Current,2022-06-03 12:30:41,2022-06-04 18:13:13,Sainsbury's,-7.15,0.00,GBP,COMPLETED,5423.02
TRANSFER,Current,2022-06-05 07:06:04,2022-06-05 07:06:04,To GBP Rainy day,-5.00,0.00,GBP,COMPLETED,5418.02
CARD_PAYMENT,Current,2022-06-04 11:57:10,2022-06-05 10:40:16,Sainsbury's,-13.80,0.00,GBP,COMPLETED,5404.22
TRANSFER,Current,2022-06-05 11:43:38,2022-06-05 11:43:38,To GBP Rainy day,-1.95,0.00,GBP,COMPLETED,5402.27
TRANSFER,Current,2022-06-05 12:13:15,2022-06-05 12:13:15,To GBP Rainy day,-3.00,0.00,GBP,COMPLETED,5399.27
TRANSFER,Current,2022-06-05 13:30:55,2022-06-05 13:30:55,To GBP Rainy day,-0.06,0.00,GBP,COMPLETED,5399.21
TRANSFER,Current,2022-06-05 15:21:26,2022-06-05 15:21:26,To GBP Rainy day,-1.95,0.00,GBP,COMPLETED,5397.26
TRANSFER,Current,2022-06-05 18:28:05,2022-06-05 18:28:05,To GBP Rainy day,-0.60,0.00,GBP,COMPLETED,5396.66
CARD_PAYMENT,Current,2022-06-04 11:01:54,2022-06-05 18:40:20,News On The Wharf,-11.98,0.00,GBP,COMPLETED,5384.68
TRANSFER,Current,2022-06-05 19:51:40,2022-06-05 19:51:40,To GBP Rainy day,-2.76,0.00,GBP,COMPLETED,5381.92
CARD_PAYMENT,Current,2022-06-04 10:16:04,2022-06-05 20:00:01,Starbucks,-3.35,0.00,GBP,COMPLETED,5378.57
TRANSFER,Current,2022-06-06 01:15:34,2022-06-06 01:15:34,To GBP Rainy day,-0.60,0.00,GBP,COMPLETED,5377.97
TRANSFER,Current,2022-06-06 07:23:10,2022-06-06 07:23:10,To GBP Rainy day,-5.00,0.00,GBP,COMPLETED,5372.97
TRANSFER,Current,2022-06-06 09:52:52,2022-06-06 09:52:52,To GBP Rainy day,-1.95,0.00,GBP,COMPLETED,5371.02
CARD_PAYMENT,Current,2022-06-05 13:30:54,2022-06-06 10:05:54,News On The Wharf,-12.98,0.00,GBP,COMPLETED,5358.04
CARD_PAYMENT,Current,2022-06-05 12:13:14,2022-06-06 10:25:14,Adam Grooming Atelier,-30.00,0.00,GBP,COMPLETED,5328.04
CARD_PAYMENT,Current,2022-06-04 10:56:23,2022-06-06 11:19:54,Marks & Spencer,-51.65,0.00,GBP,COMPLETED,5276.39
CARD_PAYMENT,Current,2022-06-05 11:43:38,2022-06-06 11:25:31,Starbucks,-3.35,0.00,GBP,COMPLETED,5273.04
TRANSFER,Current,2022-06-06 11:39:42,2022-06-06 11:39:42,To GBP Rainy day,-0.03,0.00,GBP,COMPLETED,5273.01
CARD_PAYMENT,Current,2022-06-05 15:21:26,2022-06-06 12:34:52,Seoul Bird,-27.35,0.00,GBP,COMPLETED,5245.66
CARD_PAYMENT,Current,2022-06-05 19:51:40,2022-06-06 12:43:33,Humble Grape,-24.08,0.00,GBP,COMPLETED,5221.58
CARD_PAYMENT,Current,2022-06-06 01:15:34,2022-06-06 13:24:56,Transport for London,-6.80,0.00,GBP,COMPLETED,5214.78
TRANSFER,Current,2022-06-06 14:04:15,2022-06-06 14:04:15,To GBP Rainy day,-0.75,0.00,GBP,COMPLETED,5214.03
TRANSFER,Current,2022-06-07 06:49:22,2022-06-07 06:49:22,To GBP Rainy day,-1.38,0.00,GBP,COMPLETED,5212.65
TRANSFER,Current,2022-06-07 07:05:06,2022-06-07 07:05:06,To GBP Rainy day,-5.00,0.00,GBP,COMPLETED,5207.65
TRANSFER,Current,2022-06-07 07:23:28,2022-06-07 07:23:28,To GBP Rainy day,-0.03,0.00,GBP,COMPLETED,5207.62
TRANSFER,Current,2022-06-07 07:26:37,2022-06-07 07:26:37,To GBP Rainy day,-0.03,0.00,GBP,COMPLETED,5207.59
TRANSFER,Current,2022-06-07 07:28:59,2022-06-07 07:28:59,To GBP Rainy day,-2.25,0.00,GBP,COMPLETED,5205.34
CARD_PAYMENT,Current,2022-06-06 09:52:52,2022-06-07 09:29:28,Starbucks,-3.35,0.00,GBP,COMPLETED,5201.99
CARD_PAYMENT,Current,2022-06-06 14:04:15,2022-06-07 11:13:21,Marugame Udon,-12.75,0.00,GBP,COMPLETED,5189.24
TRANSFER,Current,2022-06-07 11:34:31,2022-06-07 11:34:31,To GBP Rainy day,-2.61,0.00,GBP,COMPLETED,5186.63
TRANSFER,Current,2022-06-07 14:23:57,2022-06-07 14:23:57,To GBP Rainy day,-1.38,0.00,GBP,COMPLETED,5185.25
TRANSFER,Current,2022-06-07 14:32:00,2022-06-07 14:32:00,To GBP Rainy day,-1.53,0.00,GBP,COMPLETED,5183.72
TRANSFER,Current,2022-06-07 14:55:40,2022-06-07 14:55:40,To GBP Rainy day,-0.12,0.00,GBP,COMPLETED,5183.60
CARD_PAYMENT,Current,2022-06-06 11:39:42,2022-06-07 16:33:29,Apple,-14.99,0.00,GBP,COMPLETED,5168.61
TRANSFER,Current,2022-06-07 21:53:11,2022-06-07 21:53:11,To GBP Rainy day,-0.12,0.00,GBP,COMPLETED,5168.49
CARD_PAYMENT,Current,2022-06-05 18:28:01,2022-06-08 00:41:56,Exmouth Arms,-12.80,0.00,GBP,COMPLETED,5155.69
TRANSFER,Current,2022-06-08 07:05:20,2022-06-08 07:05:20,To GBP Rainy day,-5.00,0.00,GBP,COMPLETED,5150.69
TRANSFER,Current,2022-06-08 09:38:03,2022-06-08 09:38:03,To GBP Rainy day,-0.84,0.00,GBP,COMPLETED,5149.85
TRANSFER,Current,2022-06-08 12:44:05,2022-06-08 12:44:05,To GBP Rainy day,-2.16,0.00,GBP,COMPLETED,5147.69
TEMP_BLOCK,Current,2022-06-08 12:59:02,,To Faldin Max,-50.00,0.00,GBP,REVERTED,
TRANSFER,Current,2022-06-08 17:56:04,2022-06-08 17:56:04,To GBP Rainy day,-1.32,0.00,GBP,COMPLETED,5146.37
TRANSFER,Current,2022-06-08 18:02:42,2022-06-08 18:02:42,To GBP Rainy day,-0.84,0.00,GBP,COMPLETED,5145.53
TRANSFER,Current,2022-06-08 18:50:41,2022-06-08 18:50:41,To GBP Rainy day,-1.35,0.00,GBP,COMPLETED,5144.18
TRANSFER,Current,2022-06-08 19:45:14,2022-06-08 19:45:14,To GBP Rainy day,-2.76,0.00,GBP,COMPLETED,5141.42
TRANSFER,Current,2022-06-08 20:42:37,2022-06-08 20:42:37,To GBP Rainy day,-2.28,0.00,GBP,COMPLETED,5139.14
TRANSFER,Current,2022-06-08 20:57:51,2022-06-08 20:57:51,To GBP Rainy day,-1.32,0.00,GBP,COMPLETED,5137.82
TRANSFER,Current,2022-06-08 22:37:04,2022-06-08 22:37:04,To GBP Rainy day,-3.00,0.00,GBP,COMPLETED,5134.82
TRANSFER,Current,2022-06-09 06:55:15,2022-06-09 06:55:15,To GBP Rainy day,-3.00,0.00,GBP,COMPLETED,5131.82
TRANSFER,Current,2022-06-09 07:06:12,2022-06-09 07:06:12,To GBP Rainy day,-5.00,0.00,GBP,COMPLETED,5126.82
TRANSFER,Current,2022-06-09 07:06:56,2022-06-09 07:06:56,To GBP Rainy day,-0.81,0.00,GBP,COMPLETED,5126.01
TRANSFER,Current,2022-06-09 07:38:20,2022-06-09 07:38:20,To GBP Rainy day,-0.33,0.00,GBP,COMPLETED,5125.68
TRANSFER,Current,2022-06-09 08:06:26,2022-06-09 08:06:26,To GBP Rainy day,-1.89,0.00,GBP,COMPLETED,5123.79
TRANSFER,Current,2022-06-09 09:14:39,2022-06-09 09:14:39,To GBP Rainy day,-0.36,0.00,GBP,COMPLETED,5123.43
TRANSFER,Current,2022-06-09 09:20:26,2022-06-09 09:20:26,To GBP Rainy day,-1.35,0.00,GBP,COMPLETED,5122.08
TRANSFER,Current,2022-06-09 09:31:14,2022-06-09 09:31:14,To GBP Rainy day,-0.87,0.00,GBP,COMPLETED,5121.21
TRANSFER,Current,2022-06-09 10:12:59,2022-06-09 10:12:59,To GBP Rainy day,-2.22,0.00,GBP,COMPLETED,5118.99
TRANSFER,Current,2022-06-09 12:46:37,2022-06-09 12:46:37,To GBP Rainy day,-3.00,0.00,GBP,COMPLETED,5115.99
CARD_PAYMENT,Current,2022-06-07 14:31:54,2022-06-10 00:32:33,Apple,-3.49,0.00,GBP,COMPLETED,5112.50
TRANSFER,Current,2022-06-10 01:00:00,2022-06-10 01:05:24,To Billing Better,-179.16,0.00,GBP,COMPLETED,4933.34
TRANSFER,Current,2022-06-10 01:37:41,2022-06-10 01:37:41,To GBP Rainy day,-0.90,0.00,GBP,COMPLETED,4932.44
CARD_PAYMENT,Current,2022-06-07 11:34:30,2022-06-10 02:07:50,Hoteleuropaamsterd,-5.13,0.00,GBP,COMPLETED,4927.31
CARD_PAYMENT,Current,2022-06-07 06:49:21,2022-06-10 04:03:42,Uber,-25.54,0.00,GBP,COMPLETED,4901.77
CARD_PAYMENT,Current,2022-06-07 21:53:11,2022-06-10 06:16:59,Bar Twenty Two,-5.96,0.00,GBP,COMPLETED,4895.81
TRANSFER,Current,2022-06-10 07:09:08,2022-06-10 07:09:08,To GBP Rainy day,-5.00,0.00,GBP,COMPLETED,4890.81
CARD_PAYMENT,Current,2022-06-07 14:11:19,2022-06-10 07:16:44,Albert Heijn,-8.54,0.00,GBP,COMPLETED,4882.27
CARD_PAYMENT,Current,2022-06-07 07:23:28,2022-06-10 07:19:21,WHSmith,-6.99,0.00,GBP,COMPLETED,4875.28
CARD_PAYMENT,Current,2022-06-07 07:26:37,2022-06-10 07:19:22,WHSmith,-1.99,0.00,GBP,COMPLETED,4873.29
CARD_PAYMENT,Current,2022-06-07 14:55:34,2022-06-10 07:52:28,d'Overkant,-8.96,0.00,GBP,COMPLETED,4864.33
CARD_PAYMENT,Current,2022-06-07 07:28:59,2022-06-10 09:01:48,Pret,-3.25,0.00,GBP,COMPLETED,4861.08
TRANSFER,Current,2022-06-10 09:50:15,2022-06-10 09:50:15,To GBP Rainy day,-0.12,0.00,GBP,COMPLETED,4860.96
TRANSFER,Current,2022-06-10 09:53:43,2022-06-10 09:53:43,To GBP Rainy day,-1.95,0.00,GBP,COMPLETED,4859.01
TRANSFER,Current,2022-06-10 11:02:18,2022-06-10 11:02:18,To GBP Rainy day,-1.95,0.00,GBP,COMPLETED,4857.06
TRANSFER,Current,2022-06-10 14:06:34,2022-06-10 14:06:34,To GBP Rainy day,-0.15,0.00,GBP,COMPLETED,4856.91
CARD_PAYMENT,Current,2022-06-08 19:45:13,2022-06-10 15:33:34,Taboo Bar Amsterdam,-3.08,0.00,GBP,COMPLETED,4853.83
CARD_PAYMENT,Current,2022-06-08 22:37:04,2022-06-10 15:42:44,EE,-25.00,0.00,GBP,COMPLETED,4828.83
CARD_PAYMENT,Current,2022-06-08 17:56:04,2022-06-10 15:46:49,King Store Kalverstraat 7,-8.56,0.00,GBP,COMPLETED,4820.27
CARD_PAYMENT,Current,2022-06-08 20:57:51,2022-06-10 15:46:49,King Store Kalverstraat 7,-8.56,0.00,GBP,COMPLETED,4811.71
CARD_PAYMENT,Current,2022-06-08 20:42:37,2022-06-10 15:47:22,The Big Apple,-48.24,0.00,GBP,COMPLETED,4763.47
CARD_PAYMENT,Current,2022-06-08 18:50:41,2022-06-10 16:14:01,Abraxas Souvenirs,-8.55,0.00,GBP,COMPLETED,4754.92
CARD_PAYMENT,Current,2022-06-08 18:00:16,2022-06-10 16:14:13,Balvert,-1.72,0.00,GBP,COMPLETED,4753.20
TRANSFER,Current,2022-06-10 17:00:29,2022-06-10 17:00:29,To GBP Rainy day,-1.80,0.00,GBP,COMPLETED,4751.40
TRANSFER,Current,2022-06-10 17:30:10,2022-06-10 17:30:10,To GBP Rainy day,-0.30,0.00,GBP,COMPLETED,4751.10
CARD_PAYMENT,Current,2022-06-08 09:38:03,2022-06-10 17:31:04,Starbucks,-3.72,0.00,GBP,COMPLETED,4747.38
CARD_PAYMENT,Current,2022-06-08 12:44:05,2022-06-10 17:38:32,Albert Heijn,-7.28,0.00,GBP,COMPLETED,4740.10
CARD_PAYMENT,Current,2022-06-09 08:06:25,2022-06-11 00:14:03,HMSHost International,-4.37,0.00,GBP,COMPLETED,4735.73
CARD_PAYMENT,Current,2022-06-09 10:12:59,2022-06-11 00:14:15,HMSHost International,-3.26,0.00,GBP,COMPLETED,4732.47
CARD_PAYMENT,Current,2022-06-09 09:31:13,2022-06-11 00:14:15,HMSHost International,-10.71,0.00,GBP,COMPLETED,4721.76
CARD_PAYMENT,Current,2022-06-09 09:20:26,2022-06-11 00:14:15,HMSHost International,-9.55,0.00,GBP,COMPLETED,4712.21
CARD_PAYMENT,Current,2022-06-09 06:55:14,2022-06-11 00:19:00,Hoteleuropaamsterd,-12.00,0.00,GBP,COMPLETED,4700.21
CARD_PAYMENT,Current,2022-06-09 09:14:39,2022-06-11 03:57:34,Schiphol,-143.88,0.00,GBP,COMPLETED,4556.33
CARD_PAYMENT,Current,2022-06-09 07:06:55,2022-06-11 04:03:20,Starbucks,-3.73,0.00,GBP,COMPLETED,4552.60
CARD_PAYMENT,Current,2022-06-09 07:36:42,2022-06-11 05:26:54,NS,-4.89,0.00,GBP,COMPLETED,4547.71
CARD_PAYMENT,Current,2022-06-09 12:46:32,2022-06-11 06:29:16,Grocery Station,-10.00,0.00,GBP,COMPLETED,4537.71
CARD_PAYMENT,Current,2022-06-10 01:36:28,2022-06-11 06:43:50,Transport for London,-1.70,0.00,GBP,COMPLETED,4536.01
TRANSFER,Current,2022-06-11 07:05:36,2022-06-11 07:05:36,To GBP Rainy day,-5.00,0.00,GBP,COMPLETED,4531.01
TRANSFER,Current,2022-06-11 12:08:24,2022-06-11 12:08:24,To GBP Rainy day,-0.03,0.00,GBP,COMPLETED,4530.98
TRANSFER,Current,2022-06-11 14:24:59,2022-06-11 14:24:59,To GBP Rainy day,-2.55,0.00,GBP,COMPLETED,4528.43
CARD_PAYMENT,Current,2022-06-10 09:50:10,2022-06-11 18:21:15,News On The Wharf,-23.96,0.00,GBP,COMPLETED,4504.47
TRANSFER,Current,2022-06-11 18:25:33,2022-06-11 18:25:33,To GBP Rainy day,-0.09,0.00,GBP,COMPLETED,4504.38
TRANSFER,Current,2022-06-11 18:47:46,2022-06-11 18:47:46,To GBP Rainy day,-1.20,0.00,GBP,COMPLETED,4503.18
CARD_PAYMENT,Current,2022-06-10 11:02:18,2022-06-11 20:07:14,Starbucks,-3.35,0.00,GBP,COMPLETED,4499.83
CARD_PAYMENT,Current,2022-06-10 09:46:42,2022-06-11 20:07:14,Starbucks,-3.35,0.00,GBP,COMPLETED,4496.48
TRANSFER,Current,2022-06-11 20:53:56,2022-06-11 20:53:56,To GBP Rainy day,-2.40,0.00,GBP,COMPLETED,4494.08
TRANSFER,Current,2022-06-11 21:23:02,2022-06-11 21:23:02,To GBP Rainy day,-3.00,0.00,GBP,COMPLETED,4491.08
CARD_PAYMENT,Current,2022-06-10 14:06:30,2022-06-11 21:39:11,Seoul Bird,-10.95,0.00,GBP,COMPLETED,4480.13
TRANSFER,Current,2022-06-11 22:31:51,2022-06-11 22:31:51,To GBP Rainy day,-0.54,0.00,GBP,COMPLETED,4479.59
TRANSFER,Current,2022-06-12 01:26:59,2022-06-12 01:26:59,To GBP Rainy day,-1.20,0.00,GBP,COMPLETED,4478.39
TRANSFER,Current,2022-06-12 07:05:21,2022-06-12 07:05:21,To GBP Rainy day,-5.00,0.00,GBP,COMPLETED,4473.39
TRANSFER,Current,2022-06-12 11:42:57,2022-06-12 11:42:57,To GBP Rainy day,-1.74,0.00,GBP,COMPLETED,4471.65
CARD_PAYMENT,Current,2022-06-11 18:25:33,2022-06-12 12:14:08,SPIRITS OF EAST,-20.97,0.00,GBP,COMPLETED,4450.68
TRANSFER,Current,2022-06-12 12:20:50,2022-06-12 12:20:50,To GBP Rainy day,-2.10,0.00,GBP,COMPLETED,4448.58
CARD_PAYMENT,Current,2022-06-11 18:47:05,2022-06-12 12:24:27,Trainline,-25.60,0.00,GBP,COMPLETED,4422.98
TRANSFER,Current,2022-06-12 12:30:01,2022-06-12 12:30:01,To GBP Rainy day,-2.40,0.00,GBP,COMPLETED,4420.58
TRANSFER,Current,2022-06-12 12:49:51,2022-06-12 12:49:51,To GBP Rainy day,-2.70,0.00,GBP,COMPLETED,4417.88
TRANSFER,Current,2022-06-12 14:17:43,2022-06-12 14:17:43,To GBP Rainy day,-1.95,0.00,GBP,COMPLETED,4415.93
CARD_PAYMENT,Current,2022-06-10 17:00:24,2022-06-12 14:37:43,No 35 Mackenzie Walk,-20.40,0.00,GBP,COMPLETED,4395.53
CARD_PAYMENT,Current,2022-06-10 17:30:05,2022-06-12 14:37:43,No 35 Mackenzie Walk,-13.90,0.00,GBP,COMPLETED,4381.63
TRANSFER,Current,2022-06-12 14:46:38,2022-06-12 14:46:38,To GBP Rainy day,-0.30,0.00,GBP,COMPLETED,4381.33
CARD_PAYMENT,Current,2022-06-11 20:53:55,2022-06-12 15:40:09,Whippet,-2.20,0.00,GBP,COMPLETED,4379.13
CARD_PAYMENT,Current,2022-06-11 21:23:02,2022-06-12 16:06:40,Hyatt Hotels,-200.00,0.00,GBP,COMPLETED,4179.13
CARD_PAYMENT,Current,2022-06-11 14:24:55,2022-06-12 16:24:42,Sainsbury's,-33.15,0.00,GBP,COMPLETED,4145.98
CARD_PAYMENT,Current,2022-06-12 01:26:59,2022-06-12 16:35:26,Transport for London,-2.60,0.00,GBP,COMPLETED,4143.38
TRANSFER,Current,2022-06-12 17:04:06,2022-06-12 17:04:06,To GBP Rainy day,-3.00,0.00,GBP,COMPLETED,4140.38
TRANSFER,Current,2022-06-12 17:31:39,2022-06-12 17:31:39,To GBP Rainy day,-1.20,0.00,GBP,COMPLETED,4139.18
CARD_PAYMENT,Current,2022-06-11 22:31:51,2022-06-12 18:00:00,Kota,-72.82,0.00,GBP,COMPLETED,4066.36
TRANSFER,Current,2022-06-12 18:03:35,2022-06-12 18:03:35,To GBP Rainy day,-1.20,0.00,GBP,COMPLETED,4065.16
TRANSFER,Current,2022-06-12 19:30:12,2022-06-12 19:30:12,To GBP Rainy day,-2.70,0.00,GBP,COMPLETED,4062.46
TRANSFER,Current,2022-06-12 19:34:22,2022-06-12 19:34:22,To GBP Rainy day,-0.90,0.00,GBP,COMPLETED,4061.56
TRANSFER,Current,2022-06-12 20:35:32,2022-06-12 20:35:32,To GBP Rainy day,-1.50,0.00,GBP,COMPLETED,4060.06
TRANSFER,Current,2022-06-12 20:38:45,2022-06-12 20:38:45,To GBP Rainy day,-1.50,0.00,GBP,COMPLETED,4058.56
CARD_PAYMENT,Current,2022-06-11 12:08:24,2022-06-12 22:22:34,Apple,-4.99,0.00,GBP,COMPLETED,4053.57
TEMP_BLOCK,Current,2022-06-13 06:57:20,,To Faldin Max,-1100.00,0.00,GBP,REVERTED,
TRANSFER,Current,2022-06-13 07:23:14,2022-06-13 07:23:14,To GBP Rainy day,-5.00,0.00,GBP,COMPLETED,4048.57
CARD_PAYMENT,Current,2022-06-12 12:30:00,2022-06-13 10:19:01,Whippet,-2.20,0.00,GBP,COMPLETED,4046.37
TRANSFER,Current,2022-06-13 10:26:07,2022-06-13 10:26:07,To GBP Rainy day,-1.20,0.00,GBP,COMPLETED,4045.17
CARD_PAYMENT,Current,2022-06-12 17:31:39,2022-06-13 10:56:40,Caley Hall Hotel Limit,-14.60,0.00,GBP,COMPLETED,4030.57
CARD_PAYMENT,Current,2022-06-12 19:34:22,2022-06-13 10:56:51,Caley Hall Hotel Limit,-3.70,0.00,GBP,COMPLETED,4026.87
CARD_PAYMENT,Current,2022-06-12 19:30:11,2022-06-13 10:56:51,Caley Hall Hotel Limit,-80.10,0.00,GBP,COMPLETED,3946.77
CARD_PAYMENT,Current,2022-06-12 20:38:45,2022-06-13 10:56:51,Caley Hall Hotel Limit,-10.50,0.00,GBP,COMPLETED,3936.27
CARD_PAYMENT,Current,2022-06-12 18:03:34,2022-06-13 10:56:51,Caley Hall Hotel Limit,-14.60,0.00,GBP,COMPLETED,3921.67
CARD_PAYMENT,Current,2022-06-12 20:33:42,2022-06-13 10:56:51,Caley Hall Hotel Limit,-15.50,0.00,GBP,COMPLETED,3906.17
CARD_PAYMENT,Current,2022-06-12 17:04:05,2022-06-13 10:59:15,Caley Hall Hotel Limit,-125.00,0.00,GBP,COMPLETED,3781.17
CARD_PAYMENT,Current,2022-06-12 12:49:51,2022-06-13 11:17:44,Marks & Spencer,-2.10,0.00,GBP,COMPLETED,3779.07
CARD_PAYMENT,Current,2022-06-12 14:17:43,2022-06-13 11:22:08,Costa Coffee,-3.35,0.00,GBP,COMPLETED,3775.72
CARD_PAYMENT,Current,2022-06-12 14:44:57,2022-06-13 11:23:04,Lynx,-3.90,0.00,GBP,COMPLETED,3771.82
TRANSFER,Current,2022-06-13 12:47:04,2022-06-13 12:47:04,To GBP Rainy day,-0.15,0.00,GBP,COMPLETED,3771.67
TRANSFER,Current,2022-06-13 14:23:51,2022-06-13 14:23:51,To GBP Rainy day,-0.90,0.00,GBP,COMPLETED,3770.77
CARD_PAYMENT,Current,2022-06-12 11:42:56,2022-06-13 14:41:18,Sainsbury's,-4.42,0.00,GBP,COMPLETED,3766.35
TRANSFER,Current,2022-06-13 18:31:34,2022-06-13 18:31:34,To GBP Rainy day,-0.45,0.00,GBP,COMPLETED,3765.90
TRANSFER,Current,2022-06-13 20:52:11,2022-06-13 20:52:13,To Mikhail Balabanov,-100.00,0.00,GBP,COMPLETED,3665.90
CARD_PAYMENT,Current,2022-06-12 12:20:50,2022-06-13 23:43:27,Trainline,-11.30,0.00,GBP,COMPLETED,3654.60
TRANSFER,Current,2022-06-14 01:30:07,2022-06-14 01:30:07,To GBP Rainy day,-1.20,0.00,GBP,COMPLETED,3653.40
TRANSFER,Current,2022-06-14 07:04:55,2022-06-14 07:04:55,To GBP Rainy day,-5.00,0.00,GBP,COMPLETED,3648.40
CARD_PAYMENT,Current,2022-06-13 10:26:07,2022-06-14 09:39:46,Trainline,-50.60,0.00,GBP,COMPLETED,3597.80
TRANSFER,Current,2022-06-14 11:30:01,2022-06-14 11:30:01,To GBP Rainy day,-1.95,0.00,GBP,COMPLETED,3595.85
CARD_PAYMENT,Current,2022-06-13 12:47:04,2022-06-14 11:41:02,Starbucks,-5.95,0.00,GBP,COMPLETED,3589.90
CARD_PAYMENT,Current,2022-06-13 14:20:37,2022-06-14 13:01:51,Canary Wharf,-4.70,0.00,GBP,COMPLETED,3585.20
TRANSFER,Current,2022-06-14 13:14:53,2022-06-14 13:14:53,To GBP Rainy day,-0.09,0.00,GBP,COMPLETED,3585.11
TRANSFER,Current,2022-06-14 13:20:55,2022-06-14 13:20:55,To GBP Rainy day,-2.40,0.00,GBP,COMPLETED,3582.71
CARD_PAYMENT,Current,2022-06-14 01:29:57,2022-06-14 14:38:03,Transport for London,-2.60,0.00,GBP,COMPLETED,3580.11
TRANSFER,Current,2022-06-14 20:12:26,2022-06-14 20:12:26,To GBP Rainy day,-2.07,0.00,GBP,COMPLETED,3578.04
TRANSFER,Current,2022-06-14 20:34:03,2022-06-14 20:34:03,To GBP Rainy day,-1.20,0.00,GBP,COMPLETED,3576.84
TRANSFER,Current,2022-06-14 20:59:54,2022-06-14 20:59:54,To GBP Rainy day,-0.15,0.00,GBP,COMPLETED,3576.69
TRANSFER,Current,2022-06-15 07:05:58,2022-06-15 07:05:58,To GBP Rainy day,-5.00,0.00,GBP,COMPLETED,3571.69
CARD_PAYMENT,Current,2022-06-14 11:29:10,2022-06-15 10:28:14,Starbucks,-3.35,0.00,GBP,COMPLETED,3568.34
TRANSFER,Current,2022-06-15 10:44:09,2022-06-15 10:44:09,To GBP Rainy day,-1.95,0.00,GBP,COMPLETED,3566.39
CARD_PAYMENT,Current,2022-06-14 20:34:03,2022-06-15 11:41:00,Riverside Supermarket,-1.60,0.00,GBP,COMPLETED,3564.79
CARD_PAYMENT,Current,2022-06-14 20:12:26,2022-06-15 11:41:00,Cafe Brera,-7.31,0.00,GBP,COMPLETED,3557.48
TRANSFER,Current,2022-06-15 11:53:25,2022-06-15 11:53:25,To GBP Rainy day,-0.06,0.00,GBP,COMPLETED,3557.42
TRANSFER,Current,2022-06-15 12:01:02,2022-06-15 12:01:02,To GBP Rainy day,-2.40,0.00,GBP,COMPLETED,3555.02
TRANSFER,Current,2022-06-15 13:54:10,2022-06-15 13:54:10,To GBP Rainy day,-0.90,0.00,GBP,COMPLETED,3554.12
TRANSFER,Current,2022-06-15 19:27:57,2022-06-15 19:27:57,To GBP Rainy day,-1.14,0.00,GBP,COMPLETED,3552.98
CARD_PAYMENT,Current,2022-06-13 18:31:31,2022-06-15 22:01:39,Just Eat,-60.85,0.00,GBP,COMPLETED,3492.13
CARD_PAYMENT,Current,2022-06-14 13:20:51,2022-06-15 22:11:24,Notes,-3.20,0.00,GBP,COMPLETED,3488.93
CARD_PAYMENT,Current,2022-06-14 13:14:53,2022-06-15 22:11:34,News On The Wharf,-17.97,0.00,GBP,COMPLETED,3470.96
CARD_PAYMENT,Current,2022-06-14 20:58:22,2022-06-15 22:45:42,Nisa,-17.95,0.00,GBP,COMPLETED,3453.01
TRANSFER,Current,2022-06-16 01:48:42,2022-06-16 01:48:42,To GBP Rainy day,-1.20,0.00,GBP,COMPLETED,3451.81
TRANSFER,Current,2022-06-16 07:06:22,2022-06-16 07:06:22,To GBP Rainy day,-5.00,0.00,GBP,COMPLETED,3446.81
TRANSFER,Current,2022-06-16 10:08:24,2022-06-16 10:08:24,To GBP Rainy day,-1.95,0.00,GBP,COMPLETED,3444.86
CARD_PAYMENT,Current,2022-06-15 10:44:05,2022-06-16 11:37:58,Starbucks,-3.35,0.00,GBP,COMPLETED,3441.51
TRANSFER,Current,2022-06-16 11:47:01,2022-06-16 11:47:01,To GBP Rainy day,-3.00,0.00,GBP,COMPLETED,3438.51
CARD_PAYMENT,Current,2022-06-15 19:27:54,2022-06-16 12:20:01,Waitrose & Partners,-109.62,0.00,GBP,COMPLETED,3328.89
CARD_PAYMENT,Current,2022-06-15 13:53:55,2022-06-16 12:39:04,Canary Wharf,-4.70,0.00,GBP,COMPLETED,3324.19
TRANSFER,Current,2022-06-16 13:29:34,2022-06-16 13:29:34,To GBP Rainy day,-0.06,0.00,GBP,COMPLETED,3324.13
TRANSFER,Current,2022-06-16 13:31:21,2022-06-16 13:31:21,To GBP Rainy day,-1.65,0.00,GBP,COMPLETED,3322.48
CARD_PAYMENT,Current,2022-06-16 01:48:42,2022-06-16 14:34:19,Transport for London,-1.60,0.00,GBP,COMPLETED,3320.88
TRANSFER,Current,2022-06-16 19:32:19,2022-06-16 19:32:19,To GBP Rainy day,-1.20,0.00,GBP,COMPLETED,3319.68
CARD_PAYMENT,Current,2022-06-15 11:53:21,2022-06-16 19:37:27,Amazon,-96.98,0.00,GBP,COMPLETED,3222.70
TRANSFER,Current,2022-06-16 19:49:52,2022-06-16 19:49:52,To GBP Rainy day,-3.00,0.00,GBP,COMPLETED,3219.70
CARD_PAYMENT,Current,2022-06-15 12:00:59,2022-06-16 20:08:10,Notes,-3.20,0.00,GBP,COMPLETED,3216.50
TRANSFER,Current,2022-06-17 07:08:20,2022-06-17 07:08:20,To GBP Rainy day,-5.00,0.00,GBP,COMPLETED,3211.50
TRANSFER,Current,2022-06-17 08:21:11,2022-06-17 08:21:11,To GBP Rainy day,-1.95,0.00,GBP,COMPLETED,3209.55
TRANSFER,Current,2022-06-17 11:00:38,2022-06-17 11:00:38,To GBP Rainy day,-3.00,0.00,GBP,COMPLETED,3206.55
CARD_PAYMENT,Current,2022-06-16 10:08:23,2022-06-17 11:30:41,Starbucks,-3.35,0.00,GBP,COMPLETED,3203.20
CARD_PAYMENT,Current,2022-06-16 11:47:00,2022-06-17 12:38:40,Canary Wharf,-5.00,0.00,GBP,COMPLETED,3198.20
CARD_PAYMENT,Current,2022-06-16 13:31:20,2022-06-17 12:38:40,Canary Wharf,-7.45,0.00,GBP,COMPLETED,3190.75
TRANSFER,Current,2022-06-17 13:08:36,2022-06-17 13:08:36,To GBP Rainy day,-0.09,0.00,GBP,COMPLETED,3190.66
CARD_PAYMENT,Current,2022-06-16 19:49:52,2022-06-17 14:10:56,Sainsbury's,-3.00,0.00,GBP,COMPLETED,3187.66
TRANSFER,Current,2022-06-17 16:51:20,2022-06-17 16:51:20,To GBP Rainy day,-2.13,0.00,GBP,COMPLETED,3185.53
CARD_PAYMENT,Current,2022-06-16 13:29:34,2022-06-17 18:27:02,News On The Wharf,-11.98,0.00,GBP,COMPLETED,3173.55
TRANSFER,Current,2022-06-17 19:44:03,2022-06-17 19:44:03,To GBP Rainy day,-1.41,0.00,GBP,COMPLETED,3172.14
TRANSFER,Current,2022-06-18 01:33:23,2022-06-18 01:33:23,To GBP Rainy day,-1.80,0.00,GBP,COMPLETED,3170.34
TRANSFER,Current,2022-06-18 07:05:30,2022-06-18 07:05:30,To GBP Rainy day,-5.00,0.00,GBP,COMPLETED,3165.34
TRANSFER,Current,2022-06-18 07:49:47,2022-06-18 07:49:47,To GBP Rainy day,-0.63,0.00,GBP,COMPLETED,3164.71
TRANSFER,Current,2022-06-18 10:27:07,2022-06-18 10:27:07,To GBP Rainy day,-0.60,0.00,GBP,COMPLETED,3164.11
CARD_PAYMENT,Current,2022-06-17 08:21:10,2022-06-18 11:04:25,Starbucks,-3.35,0.00,GBP,COMPLETED,3160.76
TRANSFER,Current,2022-06-18 11:05:06,2022-06-18 11:05:06,To GBP Rainy day,-3.00,0.00,GBP,COMPLETED,3157.76
CARD_PAYMENT,Current,2022-06-17 19:44:00,2022-06-18 11:54:34,Waitrose & Partners,-72.53,0.00,GBP,COMPLETED,3085.23
CARD_PAYMENT,Current,2022-06-17 11:00:38,2022-06-18 14:42:19,Colicci,-2.00,0.00,GBP,COMPLETED,3083.23
CARD_PAYMENT,Current,2022-06-18 01:33:23,2022-06-18 15:02:38,Transport for London,-7.40,0.00,GBP,COMPLETED,3075.83
TRANSFER,Current,2022-06-18 17:52:20,2022-06-18 17:52:20,To GBP Rainy day,-3.00,0.00,GBP,COMPLETED,3072.83
TRANSFER,Current,2022-06-18 18:33:36,2022-06-18 18:33:36,To GBP Rainy day,-0.75,0.00,GBP,COMPLETED,3072.08
TRANSFER,Current,2022-06-18 18:39:52,2022-06-18 18:39:52,To GBP Rainy day,-1.77,0.00,GBP,COMPLETED,3070.31
TRANSFER,Current,2022-06-18 19:24:53,2022-06-18 19:24:53,To GBP Rainy day,-1.74,0.00,GBP,COMPLETED,3068.57
TRANSFER,Current,2022-06-18 22:42:19,2022-06-18 22:42:19,To GBP Rainy day,-2.31,0.00,GBP,COMPLETED,3066.26
TRANSFER,Current,2022-06-18 22:49:46,2022-06-18 22:49:46,To GBP Rainy day,-3.00,0.00,GBP,COMPLETED,3063.26
CARD_PAYMENT,Current,2022-06-17 16:50:49,2022-06-19 01:36:32,Trainline,-22.29,0.00,GBP,COMPLETED,3040.97
TRANSFER,Current,2022-06-19 01:41:22,2022-06-19 01:41:22,To GBP Rainy day,-1.20,0.00,GBP,COMPLETED,3039.77
CARD_PAYMENT,Current,2022-06-16 19:32:19,2022-06-19 01:43:58,Riverside Supermarket,-1.60,0.00,GBP,COMPLETED,3038.17
CARD_PAYMENT,Current,2022-06-17 13:08:24,2022-06-19 01:56:33,News On The Wharf,-17.97,0.00,GBP,COMPLETED,3020.20
TRANSFER,Current,2022-06-19 07:05:13,2022-06-19 07:05:13,To GBP Rainy day,-5.00,0.00,GBP,COMPLETED,3015.20
TRANSFER,Current,2022-06-19 10:32:59,2022-06-19 10:32:59,To GBP Rainy day,-0.69,0.00,GBP,COMPLETED,3014.51
TRANSFER,Current,2022-06-19 11:05:22,2022-06-19 11:05:22,To GBP Rainy day,-0.90,0.00,GBP,COMPLETED,3013.61
TRANSFER,Current,2022-06-19 11:13:35,2022-06-19 11:13:35,To GBP Rainy day,-3.00,0.00,GBP,COMPLETED,3010.61
TRANSFER,Current,2022-06-19 13:49:54,2022-06-19 13:49:54,To GBP Rainy day,-0.03,0.00,GBP,COMPLETED,3010.58
CARD_PAYMENT,Current,2022-06-18 10:49:08,2022-06-19 13:58:07,Rspca Solent B,-8.00,0.00,GBP,COMPLETED,3002.58
CARD_PAYMENT,Current,2022-06-18 09:52:33,2022-06-19 15:06:36,Gosport Ferry,-5.80,0.00,GBP,COMPLETED,2996.78
CARD_PAYMENT,Current,2022-06-18 22:49:45,2022-06-19 15:21:13,EE,-27.00,0.00,GBP,COMPLETED,2969.78
CARD_PAYMENT,Current,2022-06-18 07:49:47,2022-06-19 16:09:04,Upper Crust,-2.79,0.00,GBP,COMPLETED,2966.99
CARD_PAYMENT,Current,2022-06-18 18:33:36,2022-06-19 18:18:57,Marriott Hotel,-4.75,0.00,GBP,COMPLETED,2962.24
CARD_PAYMENT,Current,2022-06-18 22:42:19,2022-06-19 18:18:58,Marriott Hotel,-221.23,0.00,GBP,COMPLETED,2741.01
TRANSFER,Current,2022-06-20 01:16:50,2022-06-20 01:16:50,To GBP Rainy day,-1.20,0.00,GBP,COMPLETED,2739.81
TRANSFER,Current,2022-06-20 07:23:41,2022-06-20 07:23:41,To GBP Rainy day,-5.00,0.00,GBP,COMPLETED,2734.81
TRANSFER,Current,2022-06-20 07:58:59,2022-06-20 07:58:59,To GBP Rainy day,-1.95,0.00,GBP,COMPLETED,2732.86
TRANSFER,Current,2022-06-20 09:35:16,2022-06-20 09:35:16,To GBP Rainy day,-1.95,0.00,GBP,COMPLETED,2730.91
CARD_PAYMENT,Current,2022-06-18 17:52:20,2022-06-20 10:42:49,Marriott Hotel,-259.00,0.00,GBP,COMPLETED,2471.91
CARD_PAYMENT,Current,2022-06-19 01:41:21,2022-06-20 10:42:50,Transport for London,-2.60,0.00,GBP,COMPLETED,2469.31
TRANSFER,Current,2022-06-20 11:45:05,2022-06-20 11:45:05,To GBP Rainy day,-0.75,0.00,GBP,COMPLETED,2468.56
TRANSFER,Current,2022-06-20 12:26:44,2022-06-20 12:26:45,To Maxim Faldin,-1040.00,0.00,GBP,COMPLETED,1428.56
CARD_PAYMENT,Current,2022-06-18 19:24:53,2022-06-20 14:25:50,Uber,-11.42,0.00,GBP,COMPLETED,1417.14
CARD_PAYMENT,Current,2022-06-19 10:32:59,2022-06-20 14:28:17,Uber,-26.77,0.00,GBP,COMPLETED,1390.37
CARD_PAYMENT,Current,2022-06-19 11:13:35,2022-06-20 14:49:00,Pumpkin Cafe Shop,-3.00,0.00,GBP,COMPLETED,1387.37
TRANSFER,Current,2022-06-20 14:56:22,2022-06-20 14:56:22,To GBP Rainy day,-3.00,0.00,GBP,COMPLETED,1384.37
TRANSFER,Current,2022-06-20 15:36:20,2022-06-20 15:36:20,To GBP Rainy day,-2.91,0.00,GBP,COMPLETED,1381.46
CARD_PAYMENT,Current,2022-06-19 13:49:54,2022-06-20 15:43:19,Supermart Express,-13.99,0.00,GBP,COMPLETED,1367.47
CARD_PAYMENT,Current,2022-06-18 18:39:52,2022-06-20 16:39:35,Uber,-10.44,0.00,GBP,COMPLETED,1357.03
TRANSFER,Current,2022-06-20 16:47:28,2022-06-20 16:47:28,To GBP Rainy day,-3.00,0.00,GBP,COMPLETED,1354.03
TRANSFER,Current,2022-06-20 17:02:43,2022-06-20 17:02:43,To GBP Rainy day,-0.66,0.00,GBP,COMPLETED,1353.37
CARD_PAYMENT,Current,2022-06-20 01:16:50,2022-06-20 17:34:53,Transport for London,-2.60,0.00,GBP,COMPLETED,1350.77
TRANSFER,Current,2022-06-21 07:04:53,2022-06-21 07:04:53,To GBP Rainy day,-5.00,0.00,GBP,COMPLETED,1345.77
CARD_PAYMENT,Current,2022-06-19 11:05:22,2022-06-21 08:55:32,Trainline,-45.70,0.00,GBP,COMPLETED,1300.07
CARD_PAYMENT,Current,2022-06-20 17:02:43,2022-06-21 09:05:58,Myblu Uk,-90.78,0.00,GBP,COMPLETED,1209.29
TRANSFER,Current,2022-06-21 09:06:45,2022-06-21 09:06:45,To GBP Rainy day,-1.95,0.00,GBP,COMPLETED,1207.34
CARD_PAYMENT,Current,2022-06-20 07:58:59,2022-06-21 10:56:15,Starbucks,-3.35,0.00,GBP,COMPLETED,1203.99
CARD_PAYMENT,Current,2022-06-20 09:35:16,2022-06-21 10:56:15,Starbucks,-3.35,0.00,GBP,COMPLETED,1200.64
CARD_PAYMENT,Current,2022-06-20 14:56:22,2022-06-21 11:46:49,gov.uk,-34.00,0.00,GBP,COMPLETED,1166.64
CARD_PAYMENT,Current,2022-06-20 16:47:28,2022-06-21 11:52:41,Waitrose & Partners,-6.00,0.00,GBP,COMPLETED,1160.64
CARD_PAYMENT,Current,2022-06-20 11:45:05,2022-06-21 12:32:56,Marugame Udon,-12.75,0.00,GBP,COMPLETED,1147.89
CARD_PAYMENT,Current,2022-06-20 15:36:19,2022-06-21 13:46:32,Holland & Barrett,-41.03,0.00,GBP,COMPLETED,1106.86
TRANSFER,Current,2022-06-21 14:53:28,2022-06-21 14:53:28,To GBP Rainy day,-2.40,0.00,GBP,COMPLETED,1104.46
TRANSFER,Current,2022-06-21 17:30:26,2022-06-21 17:30:26,To GBP Rainy day,-0.45,0.00,GBP,COMPLETED,1104.01
CARD_REFUND,Current,2022-06-21 01:00:00,2022-06-21 17:55:49,Marriott Hotel,50.00,0.00,GBP,COMPLETED,1154.01
TRANSFER,Current,2022-06-21 20:37:28,2022-06-21 20:37:28,To GBP Rainy day,-0.90,0.00,GBP,COMPLETED,1153.11
TRANSFER,Current,2022-06-21 21:00:32,2022-06-21 21:00:32,To GBP Rainy day,-0.60,0.00,GBP,COMPLETED,1152.51
TRANSFER,Current,2022-06-21 21:48:45,2022-06-21 21:48:45,To GBP Rainy day,-3.00,0.00,GBP,COMPLETED,1149.51
TRANSFER,Current,2022-06-21 21:52:51,2022-06-21 21:52:51,To GBP Rainy day,-3.00,0.00,GBP,COMPLETED,1146.51
TRANSFER,Current,2022-06-21 22:03:03,2022-06-21 22:03:03,To GBP Rainy day,-1.83,0.00,GBP,COMPLETED,1144.68
TRANSFER,Current,2022-06-21 22:55:51,2022-06-21 22:55:51,To GBP Rainy day,-3.00,0.00,GBP,COMPLETED,1141.68
TRANSFER,Current,2022-06-22 03:17:19,2022-06-22 03:17:19,To GBP Rainy day,-0.03,0.00,GBP,COMPLETED,1141.65
TRANSFER,Current,2022-06-22 07:05:08,2022-06-22 07:05:08,To GBP Rainy day,-5.00,0.00,GBP,COMPLETED,1136.65
TRANSFER,Current,2022-06-22 09:30:46,2022-06-22 09:30:46,To GBP Rainy day,-2.10,0.00,GBP,COMPLETED,1134.55
TRANSFER,Current,2022-06-22 09:51:35,2022-06-22 09:51:35,To GBP Rainy day,-0.90,0.00,GBP,COMPLETED,1133.65
CARD_PAYMENT,Current,2022-06-21 09:06:44,2022-06-22 10:23:09,Starbucks,-3.35,0.00,GBP,COMPLETED,1130.30
CARD_PAYMENT,Current,2022-06-21 22:55:50,2022-06-22 10:32:09,EE,-18.00,0.00,GBP,COMPLETED,1112.30
CARD_PAYMENT,Current,2022-06-21 20:37:27,2022-06-22 10:41:28,Waitrose & Partners,-62.70,0.00,GBP,COMPLETED,1049.60
CARD_PAYMENT,Current,2022-06-21 21:00:32,2022-06-22 11:43:55,Riverside Supermarket,-4.80,0.00,GBP,COMPLETED,1044.80
TRANSFER,Current,2022-06-22 13:34:59,2022-06-22 13:34:59,To GBP Rainy day,-1.95,0.00,GBP,COMPLETED,1042.85
CARD_PAYMENT,Current,2022-06-21 14:53:28,2022-06-22 16:33:12,Tesco,-24.20,0.00,GBP,COMPLETED,1018.65
TRANSFER,Current,2022-06-22 19:00:41,2022-06-22 19:00:41,To GBP Rainy day,-1.80,0.00,GBP,COMPLETED,1016.85
TRANSFER,Current,2022-06-23 07:06:10,2022-06-23 07:06:10,To GBP Rainy day,-5.00,0.00,GBP,COMPLETED,1011.85
TRANSFER,Current,2022-06-23 10:13:21,2022-06-23 10:13:21,To GBP Rainy day,-1.95,0.00,GBP,COMPLETED,1009.90
CARD_PAYMENT,Current,2022-06-21 22:03:02,2022-06-23 10:43:13,Trainline,-21.39,0.00,GBP,COMPLETED,988.51
TRANSFER,Current,2022-06-23 11:47:24,2022-06-23 11:47:24,To GBP Rainy day,-2.40,0.00,GBP,COMPLETED,986.11
CARD_PAYMENT,Current,2022-06-22 09:30:46,2022-06-23 12:20:33,Starbucks,-3.30,0.00,GBP,COMPLETED,982.81
CARD_PAYMENT,Current,2022-06-22 13:34:58,2022-06-23 12:20:33,Starbucks,-3.35,0.00,GBP,COMPLETED,979.46
CARD_PAYMENT,Current,2022-06-22 19:00:40,2022-06-23 13:15:30,Riverside Supermarket,-6.40,0.00,GBP,COMPLETED,973.06
TRANSFER,Current,2022-06-23 15:12:03,2022-06-23 15:12:03,To GBP,27000.00,0.00,GBP,COMPLETED,27973.06
TRANSFER,Current,2022-06-23 15:13:40,2022-06-23 15:13:53,To Cazoo Limited,-26924.00,0.00,GBP,COMPLETED,1049.06
TRANSFER,Current,2022-06-23 18:04:11,2022-06-23 18:04:11,To GBP Rainy day,-1.50,0.00,GBP,COMPLETED,1047.56
TRANSFER,Current,2022-06-23 18:35:53,2022-06-23 18:35:53,To GBP Rainy day,-2.85,0.00,GBP,COMPLETED,1044.71
TRANSFER,Current,2022-06-23 18:39:46,2022-06-23 18:39:46,To GBP Rainy day,-1.50,0.00,GBP,COMPLETED,1043.21
TRANSFER,Current,2022-06-23 19:08:48,2022-06-23 19:08:48,To GBP Rainy day,-1.50,0.00,GBP,COMPLETED,1041.71
CARD_PAYMENT,Current,2022-06-22 03:17:19,2022-06-23 19:23:13,Apple,-6.99,0.00,GBP,COMPLETED,1034.72
TRANSFER,Current,2022-06-23 19:39:48,2022-06-23 19:39:48,To GBP Rainy day,-1.50,0.00,GBP,COMPLETED,1033.22
TRANSFER,Current,2022-06-23 19:54:17,2022-06-23 19:54:17,To GBP Rainy day,-3.00,0.00,GBP,COMPLETED,1030.22
CARD_PAYMENT,Current,2022-06-21 21:52:51,2022-06-23 20:06:58,Ryanair,-13.00,0.00,GBP,COMPLETED,1017.22
CARD_PAYMENT,Current,2022-06-21 21:48:45,2022-06-23 20:06:58,Ryanair,-13.00,0.00,GBP,COMPLETED,1004.22
TRANSFER,Current,2022-06-23 20:12:52,2022-06-23 20:12:52,To GBP Rainy day,-1.50,0.00,GBP,COMPLETED,1002.72
CARD_PAYMENT,Current,2022-06-21 17:30:26,2022-06-23 20:34:26,Pret,-10.85,0.00,GBP,COMPLETED,991.87
TRANSFER,Current,2022-06-23 21:08:14,2022-06-23 21:08:14,To GBP Rainy day,-0.93,0.00,GBP,COMPLETED,990.94
TRANSFER,Current,2022-06-23 21:08:53,2022-06-23 21:08:53,To GBP Rainy day,-3.00,0.00,GBP,COMPLETED,987.94
TRANSFER,Current,2022-06-24 01:24:38,2022-06-24 01:24:38,To GBP Rainy day,-1.20,0.00,GBP,COMPLETED,986.74
TRANSFER,Current,2022-06-24 07:08:16,2022-06-24 07:08:16,To GBP Rainy day,-5.00,0.00,GBP,COMPLETED,981.74
TRANSFER,Current,2022-06-24 11:11:49,2022-06-24 11:11:49,To GBP Rainy day,-1.95,0.00,GBP,COMPLETED,979.79
CARD_PAYMENT,Current,2022-06-22 09:51:35,2022-06-24 11:22:22,Pret,-1.70,0.00,GBP,COMPLETED,978.09
CARD_PAYMENT,Current,2022-06-23 18:35:52,2022-06-24 13:36:19,Darwin And Wallace Lim,-40.05,0.00,GBP,COMPLETED,938.04
CARD_PAYMENT,Current,2022-06-23 19:54:16,2022-06-24 13:36:19,Darwin And Wallace Lim,-7.00,0.00,GBP,COMPLETED,931.04
CARD_PAYMENT,Current,2022-06-23 10:13:20,2022-06-24 14:16:14,Starbucks,-3.35,0.00,GBP,COMPLETED,927.69
TRANSFER,Current,2022-06-24 14:43:30,2022-06-24 14:43:30,To GBP Rainy day,-2.10,0.00,GBP,COMPLETED,925.59
CARD_PAYMENT,Current,2022-06-23 21:08:53,2022-06-24 15:24:38,Riverside Supermarket,-3.00,0.00,GBP,COMPLETED,922.59
CARD_PAYMENT,Current,2022-06-23 21:08:14,2022-06-24 15:24:38,Riverside Supermarket,-9.69,0.00,GBP,COMPLETED,912.90
CARD_PAYMENT,Current,2022-06-23 11:47:23,2022-06-24 16:34:07,Marugame Udon,-9.20,0.00,GBP,COMPLETED,903.70
CARD_PAYMENT,Current,2022-06-24 01:24:37,2022-06-24 17:32:25,Transport for London,-3.60,0.00,GBP,COMPLETED,900.10
TRANSFER,Current,2022-06-24 18:42:17,2022-06-24 18:42:17,To GBP Rainy day,-1.20,0.00,GBP,COMPLETED,898.90
TRANSFER,Current,2022-06-25 07:05:52,2022-06-25 07:05:52,To GBP Rainy day,-5.00,0.00,GBP,COMPLETED,893.90
TRANSFER,Current,2022-06-25 10:03:49,2022-06-25 10:03:49,To GBP Rainy day,-0.12,0.00,GBP,COMPLETED,893.78
TRANSFER,Current,2022-06-25 20:33:01,2022-06-25 20:33:01,To GBP Rainy day,-1.11,0.00,GBP,COMPLETED,892.67
TRANSFER,Current,2022-06-25 20:56:32,2022-06-25 20:56:32,To GBP Rainy day,-0.03,0.00,GBP,COMPLETED,892.64
TRANSFER,Current,2022-06-26 00:02:01,2022-06-26 00:02:01,To GBP Rainy day,-3.00,0.00,GBP,COMPLETED,889.64
TRANSFER,Current,2022-06-26 07:05:36,2022-06-26 07:05:36,To GBP Rainy day,-5.00,0.00,GBP,COMPLETED,884.64
TRANSFER,Current,2022-06-26 13:06:11,2022-06-26 13:06:11,To GBP Rainy day,-1.95,0.00,GBP,COMPLETED,882.69
TRANSFER,Current,2022-06-26 14:40:03,2022-06-26 14:40:03,To GBP Rainy day,-0.03,0.00,GBP,COMPLETED,882.66
CARD_PAYMENT,Current,2022-06-24 14:43:30,2022-06-26 22:11:24,Starbucks,-3.30,0.00,GBP,COMPLETED,879.36
CARD_PAYMENT,Current,2022-06-24 11:11:49,2022-06-26 22:12:29,Starbucks,-3.35,0.00,GBP,COMPLETED,876.01
TRANSFER,Current,2022-06-27 07:24:06,2022-06-27 07:24:06,To GBP Rainy day,-5.00,0.00,GBP,COMPLETED,871.01
TRANSFER,Current,2022-06-27 10:33:25,2022-06-27 10:33:25,To GBP Rainy day,-2.10,0.00,GBP,COMPLETED,868.91
TRANSFER,Current,2022-06-27 11:12:02,2022-06-27 11:12:02,To GBP,4000.00,0.00,GBP,COMPLETED,4868.91
TRANSFER,Current,2022-06-27 11:12:34,2022-06-27 11:12:34,To GBP,534.16,0.00,GBP,COMPLETED,5403.07
CARD_PAYMENT,Current,2022-06-24 18:42:17,2022-06-27 13:40:48,Marks & Spencer,-47.60,0.00,GBP,COMPLETED,5355.47
TRANSFER,Current,2022-06-27 13:49:20,2022-06-27 13:49:20,To GBP Rainy day,-0.99,0.00,GBP,COMPLETED,5354.48
TRANSFER,Current,2022-06-27 13:54:26,2022-06-27 13:54:26,To GBP Rainy day,-1.65,0.00,GBP,COMPLETED,5352.83
CARD_PAYMENT,Current,2022-06-26 00:02:00,2022-06-27 14:02:54,Canopy.rent,-84.00,0.00,GBP,COMPLETED,5268.83
CARD_PAYMENT,Current,2022-06-23 20:12:51,2022-06-27 14:31:59,No 35 Mackenzie Walk,-8.50,0.00,GBP,COMPLETED,5260.33
CARD_PAYMENT,Current,2022-06-23 18:04:10,2022-06-27 14:31:59,No 35 Mackenzie Walk,-15.50,0.00,GBP,COMPLETED,5244.83
CARD_PAYMENT,Current,2022-06-23 19:08:48,2022-06-27 14:32:00,No 35 Mackenzie Walk,-15.50,0.00,GBP,COMPLETED,5229.33
CARD_PAYMENT,Current,2022-06-23 19:39:48,2022-06-27 14:32:00,No 35 Mackenzie Walk,-8.50,0.00,GBP,COMPLETED,5220.83
CARD_PAYMENT,Current,2022-06-23 18:39:46,2022-06-27 14:32:00,No 35 Mackenzie Walk,-15.50,0.00,GBP,COMPLETED,5205.33
TRANSFER,Current,2022-06-27 19:18:42,2022-06-27 19:18:42,To GBP Rainy day,-0.03,0.00,GBP,COMPLETED,5205.30
CARD_PAYMENT,Current,2022-06-25 20:56:32,2022-06-27 20:47:17,Apple,-7.99,0.00,GBP,COMPLETED,5197.31
CARD_PAYMENT,Current,2022-06-25 10:03:49,2022-06-28 02:46:07,Waitrose,-275.96,0.00,GBP,COMPLETED,4921.35
CARD_PAYMENT,Current,2022-06-25 20:33:01,2022-06-28 03:05:40,Sainsbury's,-18.63,0.00,GBP,COMPLETED,4902.72
CARD_PAYMENT,Current,2022-06-26 13:06:10,2022-06-28 04:45:54,Starbucks,-3.35,0.00,GBP,COMPLETED,4899.37
CARD_PAYMENT,Current,2022-06-26 14:40:03,2022-06-28 05:56:04,Robert Dyas,-7.99,0.00,GBP,COMPLETED,4891.38
TRANSFER,Current,2022-06-28 07:05:27,2022-06-28 07:05:27,To GBP Rainy day,-5.00,0.00,GBP,COMPLETED,4886.38
TRANSFER,Current,2022-06-28 10:13:45,2022-06-28 10:13:45,To GBP Rainy day,-1.95,0.00,GBP,COMPLETED,4884.43
TRANSFER,Current,2022-06-28 10:58:03,2022-06-28 10:58:03,To GBP Rainy day,-3.00,0.00,GBP,COMPLETED,4881.43
TRANSFER,Current,2022-06-28 13:03:27,2022-06-28 13:03:27,To GBP Rainy day,-0.45,0.00,GBP,COMPLETED,4880.98
TRANSFER,Current,2022-06-28 13:42:20,2022-06-28 13:42:20,To GBP,22000.00,0.00,GBP,COMPLETED,26880.98
CARD_PAYMENT,Current,2022-06-27 19:18:38,2022-06-28 20:02:28,Snappy Snaps,-12.99,0.00,GBP,COMPLETED,26867.99
CARD_PAYMENT,Current,2022-06-27 13:49:20,2022-06-28 22:49:13,Robert Dyas,-22.67,0.00,GBP,COMPLETED,26845.32
CARD_PAYMENT,Current,2022-06-27 13:54:25,2022-06-28 22:54:04,Waitrose & Partners,-23.45,0.00,GBP,COMPLETED,26821.87
TRANSFER,Current,2022-06-29 01:33:04,2022-06-29 01:33:04,To GBP Rainy day,-0.60,0.00,GBP,COMPLETED,26821.27
TRANSFER,Current,2022-06-29 05:28:09,2022-06-29 05:28:09,To GBP Rainy day,-0.90,0.00,GBP,COMPLETED,26820.37
TRANSFER,Current,2022-06-29 07:05:22,2022-06-29 07:05:22,To GBP Rainy day,-5.00,0.00,GBP,COMPLETED,26815.37
TRANSFER,Current,2022-06-29 09:16:05,2022-06-29 09:16:05,To GBP Rainy day,-0.12,0.00,GBP,COMPLETED,26815.25
TRANSFER,Current,2022-06-29 10:05:14,2022-06-29 10:05:14,To GBP Rainy day,-1.95,0.00,GBP,COMPLETED,26813.30
TRANSFER,Current,2022-06-29 12:37:36,2022-06-29 12:37:36,To GBP Rainy day,-3.00,0.00,GBP,COMPLETED,26810.30
CARD_PAYMENT,Current,2022-06-27 10:33:25,2022-06-29 13:32:39,Starbucks,-3.30,0.00,GBP,COMPLETED,26807.00
TRANSFER,Current,2022-06-29 13:39:02,2022-06-29 13:39:02,To GBP Rainy day,-0.03,0.00,GBP,COMPLETED,26806.97
CARD_PAYMENT,Current,2022-06-28 10:13:45,2022-06-29 14:32:15,Starbucks,-3.35,0.00,GBP,COMPLETED,26803.62
CARD_PAYMENT,Current,2022-06-28 10:58:02,2022-06-29 14:56:39,gov.uk,-510.00,0.00,GBP,COMPLETED,26293.62
CARD_PAYMENT,Current,2022-06-28 13:03:26,2022-06-29 15:16:44,Canary Wharf,-11.85,0.00,GBP,COMPLETED,26281.77
TRANSFER,Current,2022-06-29 16:48:13,2022-06-29 16:48:13,To GBP Rainy day,-2.43,0.00,GBP,COMPLETED,26279.34
CARD_PAYMENT,Current,2022-06-29 01:33:04,2022-06-29 17:06:24,Transport for London,-1.80,0.00,GBP,COMPLETED,26277.54
TRANSFER,Current,2022-06-29 19:00:00,2022-06-29 19:00:00,To GBP Rainy day,-0.99,0.00,GBP,COMPLETED,26276.55
TRANSFER,Current,2022-06-29 20:14:14,2022-06-29 20:14:14,To GBP Rainy day,-1.50,0.00,GBP,COMPLETED,26275.05
TRANSFER,Current,2022-06-29 20:35:58,2022-06-29 20:35:58,To GBP Rainy day,-1.50,0.00,GBP,COMPLETED,26273.55
TRANSFER,Current,2022-06-30 01:00:00,2022-06-30 01:01:37,To Virgin Active,-139.99,0.00,GBP,COMPLETED,26133.56
TRANSFER,Current,2022-06-30 02:32:23,2022-06-30 02:32:23,To GBP Rainy day,-2.40,0.00,GBP,COMPLETED,26131.16
TRANSFER,Current,2022-06-30 03:15:11,2022-06-30 03:15:11,To GBP Rainy day,-3.00,0.00,GBP,COMPLETED,26128.16
TRANSFER,Current,2022-06-30 04:56:42,2022-06-30 04:56:42,To GBP Rainy day,-0.03,0.00,GBP,COMPLETED,26128.13
TRANSFER,Current,2022-06-30 07:06:03,2022-06-30 07:06:03,To GBP Rainy day,-0.03,0.00,GBP,COMPLETED,26128.10
TRANSFER,Current,2022-06-30 07:06:31,2022-06-30 07:06:31,To GBP Rainy day,-0.03,0.00,GBP,COMPLETED,26128.07
TRANSFER,Current,2022-06-30 07:08:06,2022-06-30 07:08:06,To GBP Rainy day,-5.00,0.00,GBP,COMPLETED,26123.07
TRANSFER,Current,2022-06-30 09:02:03,2022-06-30 09:02:11,To Holly Michael,-2450.00,0.00,GBP,COMPLETED,23673.07
TRANSFER,Current,2022-06-30 09:26:25,2022-06-30 09:26:25,To GBP Rainy day,-1.95,0.00,GBP,COMPLETED,23671.12
CARD_PAYMENT,Current,2022-06-29 13:39:01,2022-06-30 10:00:52,Amazon Prime,-7.99,0.00,GBP,COMPLETED,23663.13
TRANSFER,Current,2022-06-30 11:11:36,2022-06-30 11:11:36,To GBP Rainy day,-0.03,0.00,GBP,COMPLETED,23663.10
CARD_PAYMENT,Current,2022-06-29 16:48:12,2022-06-30 11:13:31,Shutters,-11.19,0.00,GBP,COMPLETED,23651.91
CARD_PAYMENT,Current,2022-06-29 20:14:14,2022-06-30 11:18:55,The Paternoster,-6.50,0.00,GBP,COMPLETED,23645.41
CARD_PAYMENT,Current,2022-06-29 20:35:58,2022-06-30 11:19:08,The Paternoster,-6.50,0.00,GBP,COMPLETED,23638.91
TRANSFER,Current,2022-06-30 11:26:33,2022-06-30 11:26:33,To GBP Rainy day,-1.50,0.00,GBP,COMPLETED,23637.41
TRANSFER,Current,2022-06-30 11:38:52,2022-06-30 11:38:52,To GBP Rainy day,-1.35,0.00,GBP,COMPLETED,23636.06
CARD_PAYMENT,Current,2022-06-29 10:05:14,2022-06-30 11:45:35,Starbucks,-3.35,0.00,GBP,COMPLETED,23632.71
TRANSFER,Current,2022-06-30 11:57:30,2022-06-30 11:57:30,To GBP Savings,-23000.00,0.00,GBP,COMPLETED,632.71
TRANSFER,Current,2022-06-30 12:21:54,2022-06-30 12:21:54,To GBP,2000.00,0.00,GBP,COMPLETED,2632.71
TRANSFER,Current,2022-06-30 13:11:01,2022-06-30 13:11:08,To Mikhail Balabanov,-2000.00,0.00,GBP,COMPLETED,632.71
CARD_PAYMENT,Current,2022-06-29 12:37:36,2022-06-30 13:21:29,Marugame Udon,-14.00,0.00,GBP,COMPLETED,618.71
CARD_PAYMENT,Current,2022-06-30 04:56:42,2022-06-30 13:41:28,Netflix,-10.99,0.00,GBP,COMPLETED,607.72
CARD_PAYMENT,Current,2022-06-29 09:16:05,2022-06-30 14:21:52,Amazon,-80.96,0.00,GBP,COMPLETED,526.76
CARD_PAYMENT,Current,2022-06-29 05:28:09,2022-06-30 14:32:37,Trainline,-20.70,0.00,GBP,COMPLETED,506.06
CARD_PAYMENT,Current,2022-06-30 02:32:23,2022-06-30 15:08:18,Transport for London,-5.20,0.00,GBP,COMPLETED,500.86
TRANSFER,Current,2022-06-30 15:29:38,2022-06-30 15:29:38,To GBP Rainy day,-1.80,0.00,GBP,COMPLETED,499.06
TRANSFER,Current,2022-06-30 18:51:07,2022-06-30 18:51:07,To GBP Rainy day,-1.71,0.00,GBP,COMPLETED,497.35
TRANSFER,Current,2022-06-30 18:56:14,2022-06-30 18:56:14,To GBP Rainy day,-1.50,0.00,GBP,COMPLETED,495.85
TRANSFER,Current,2022-06-30 19:15:26,2022-06-30 19:15:26,To GBP Rainy day,-2.70,0.00,GBP,COMPLETED,493.15
TRANSFER,Current,2022-07-01 07:13:33,2022-07-01 07:13:33,To GBP Rainy day,-5.00,0.00,GBP,COMPLETED,488.15
TRANSFER,Current,2022-07-01 09:01:37,2022-07-01 09:01:37,From WECTORY LTD,6276.49,0.00,GBP,COMPLETED,6764.64
CARD_PAYMENT,Current,2022-06-29 19:00:00,2022-07-01 09:26:16,Just Eat,-35.67,0.00,GBP,COMPLETED,6728.97
CARD_PAYMENT,Current,2022-06-30 11:26:14,2022-07-01 10:11:12,Post Office,-14.50,0.00,GBP,COMPLETED,6714.47
CARD_PAYMENT,Current,2022-06-30 14:39:14,2022-07-01 10:49:26,Birley Sandwiches,-1.40,0.00,GBP,COMPLETED,6713.07
CARD_PAYMENT,Current,2022-06-30 11:11:19,2022-07-01 10:51:28,Ryman,-2.99,0.00,GBP,COMPLETED,6710.08
CARD_PAYMENT,Current,2022-06-30 03:15:10,2022-07-01 11:12:10,Loqbox,-50.00,0.00,GBP,COMPLETED,6660.08
CARD_PAYMENT,Current,2022-06-30 09:26:25,2022-07-01 12:15:36,Starbucks,-3.35,0.00,GBP,COMPLETED,6656.73
TRANSFER,Current,2022-07-01 12:24:29,2022-07-01 12:24:36,To Mikhail Balabanov,-2000.00,0.00,GBP,COMPLETED,4656.73
CARD_PAYMENT,Current,2022-06-30 11:38:40,2022-07-01 13:16:52,Canary Wharf,-13.55,0.00,GBP,COMPLETED,4643.18
CARD_PAYMENT,Current,2022-06-30 18:51:04,2022-07-01 13:42:52,Waitrose & Partners,-97.43,0.00,GBP,COMPLETED,4545.75
CARD_PAYMENT,Current,2022-06-30 18:56:14,2022-07-01 14:36:48,Greenwich Park,-2.50,0.00,GBP,COMPLETED,4543.25
TRANSFER,Current,2022-07-01 18:43:10,2022-07-01 18:43:10,To GBP Rainy day,-1.95,0.00,GBP,COMPLETED,4541.30
CARD_PAYMENT,Current,2022-06-30 07:06:03,2022-07-01 18:48:49,Apple,-5.99,0.00,GBP,COMPLETED,4535.31
CARD_PAYMENT,Current,2022-06-30 07:06:30,2022-07-01 19:45:30,Apple,-5.99,0.00,GBP,COMPLETED,4529.32
TRANSFER,Current,2022-07-02 07:06:05,2022-07-02 07:06:05,To GBP Rainy day,-5.00,0.00,GBP,COMPLETED,4524.32
TRANSFER,Current,2022-07-02 09:01:35,2022-07-02 09:01:36,To Aleksandra Balabanova,-600.00,0.00,GBP,COMPLETED,3924.32
TRANSFER,Current,2022-07-02 09:01:36,2022-07-02 09:01:36,To Natalia Balabanova,-2000.00,0.00,GBP,COMPLETED,1924.32
CARD_PAYMENT,Current,2022-06-30 19:15:26,2022-07-02 11:37:03,BP,-77.10,0.00,GBP,COMPLETED,1847.22
CARD_PAYMENT,Current,2022-07-01 18:43:10,2022-07-02 21:16:32,Booking,-196.35,0.00,GBP,COMPLETED,1650.87
TRANSFER,Current,2022-07-03 07:05:50,2022-07-03 07:05:50,To GBP Rainy day,-5.00,0.00,GBP,COMPLETED,1645.87
TRANSFER,Current,2022-07-04 07:24:19,2022-07-04 07:24:19,To GBP Rainy day,-5.00,0.00,GBP,COMPLETED,1640.87
TRANSFER,Current,2022-07-05 07:05:42,2022-07-05 07:05:42,To GBP Rainy day,-5.00,0.00,GBP,COMPLETED,1635.87
TRANSFER,Current,2022-07-06 07:05:22,2022-07-06 07:05:22,To GBP Rainy day,-5.00,0.00,GBP,COMPLETED,1630.87
CARD_REFUND,Current,2022-07-06 01:00:00,2022-07-06 10:30:28,Refund from Amz*dawoo Direct,36.99,0.00,GBP,COMPLETED,1667.86
TRANSFER,Current,2022-07-06 11:39:27,2022-07-06 11:39:27,To GBP Rainy day,-0.03,0.00,GBP,COMPLETED,1667.83
TRANSFER,Current,2022-07-06 21:03:35,2022-07-06 21:03:35,To GBP Rainy day,-2.40,0.00,GBP,COMPLETED,1665.43
TRANSFER,Current,2022-07-06 21:16:16,2022-07-06 21:16:16,To GBP Rainy day,-0.60,0.00,GBP,COMPLETED,1664.83
TRANSFER,Current,2022-07-06 21:31:04,2022-07-06 21:31:04,To GBP Rainy day,-3.00,0.00,GBP,COMPLETED,1661.83
TRANSFER,Current,2022-07-07 07:06:26,2022-07-07 07:06:26,To GBP Rainy day,-5.00,0.00,GBP,COMPLETED,1656.83
CARD_PAYMENT,Current,2022-07-06 21:16:16,2022-07-07 11:30:40,Darwin And Wallace Lim,-3.80,0.00,GBP,COMPLETED,1653.03
CARD_PAYMENT,Current,2022-07-06 21:03:34,2022-07-07 11:30:40,Darwin And Wallace Lim,-33.20,0.00,GBP,COMPLETED,1619.83
CARD_PAYMENT,Current,2022-07-06 21:31:04,2022-07-07 11:30:41,Darwin And Wallace Lim,-7.00,0.00,GBP,COMPLETED,1612.83
CARD_PAYMENT,Current,2022-07-06 11:39:26,2022-07-07 20:13:36,Apple,-14.99,0.00,GBP,COMPLETED,1597.84
TRANSFER,Current,2022-07-08 01:32:41,2022-07-08 01:32:41,To GBP Rainy day,-1.20,0.00,GBP,COMPLETED,1596.64
TRANSFER,Current,2022-07-08 07:08:36,2022-07-08 07:08:36,To GBP Rainy day,-5.00,0.00,GBP,COMPLETED,1591.64
CARD_PAYMENT,Current,2022-07-08 01:32:41,2022-07-08 14:11:32,Transport for London,-1.60,0.00,GBP,COMPLETED,1590.04
TRANSFER,Current,2022-07-08 22:28:19,2022-07-08 22:28:19,To GBP Rainy day,-3.00,0.00,GBP,COMPLETED,1587.04
TRANSFER,Current,2022-07-09 01:32:11,2022-07-09 01:32:11,To GBP Rainy day,-0.60,0.00,GBP,COMPLETED,1586.44
TRANSFER,Current,2022-07-09 07:05:30,2022-07-09 07:05:30,To GBP Rainy day,-5.00,0.00,GBP,COMPLETED,1581.44
CARD_PAYMENT,Current,2022-07-08 22:28:19,2022-07-09 12:20:42,EE,-25.00,0.00,GBP,COMPLETED,1556.44
CARD_PAYMENT,Current,2022-07-09 01:32:10,2022-07-09 22:57:30,Transport for London,-1.80,0.00,GBP,COMPLETED,1554.64
TRANSFER,Current,2022-07-10 07:06:13,2022-07-10 07:06:13,To GBP Rainy day,-5.00,0.00,GBP,COMPLETED,1549.64
TRANSFER,Current,2022-07-11 07:24:38,2022-07-11 07:24:38,To GBP Rainy day,-5.00,0.00,GBP,COMPLETED,1544.64
TRANSFER,Current,2022-07-11 11:26:13,2022-07-11 11:26:13,To GBP Rainy day,-0.18,0.00,GBP,COMPLETED,1544.46
TRANSFER,Current,2022-07-11 12:09:13,2022-07-11 12:09:13,To GBP Rainy day,-0.03,0.00,GBP,COMPLETED,1544.43
TRANSFER,Current,2022-07-11 19:47:03,2022-07-11 19:47:03,To GBP Rainy day,-3.00,0.00,GBP,COMPLETED,1541.43
TRANSFER,Current,2022-07-12 01:00:00,2022-07-12 01:03:23,To Billing Better,-182.82,0.00,GBP,COMPLETED,1358.61
TRANSFER,Current,2022-07-12 07:05:06,2022-07-12 07:05:06,To GBP Rainy day,-5.00,0.00,GBP,COMPLETED,1353.61
CARD_PAYMENT,Current,2022-07-11 11:26:09,2022-07-12 14:21:43,Amazon,-70.94,0.00,GBP,COMPLETED,1282.67
CARD_PAYMENT,Current,2022-07-11 12:09:13,2022-07-12 17:18:09,Apple,-4.99,0.00,GBP,COMPLETED,1277.68
TRANSFER,Current,2022-07-12 19:45:38,2022-07-12 19:45:38,To GBP Rainy day,-2.25,0.00,GBP,COMPLETED,1275.43
TRANSFER,Current,2022-07-13 07:05:11,2022-07-13 07:05:11,To GBP Rainy day,-5.00,0.00,GBP,COMPLETED,1270.43
CARD_PAYMENT,Current,2022-07-11 19:47:02,2022-07-13 16:40:44,Transport for London,-80.00,0.00,GBP,COMPLETED,1190.43
CARD_PAYMENT,Current,2022-07-12 19:45:38,2022-07-14 06:35:36,IKEA,-183.25,0.00,GBP,COMPLETED,1007.18
TRANSFER,Current,2022-07-14 07:06:15,2022-07-14 07:06:15,To GBP Rainy day,-5.00,0.00,GBP,COMPLETED,1002.18
TRANSFER,Current,2022-07-15 07:09:14,2022-07-15 07:09:14,To GBP Rainy day,-5.00,0.00,GBP,COMPLETED,997.18
TRANSFER,Current,2022-07-16 01:28:04,2022-07-16 01:28:04,To GBP Rainy day,-2.40,0.00,GBP,COMPLETED,994.78
TRANSFER,Current,2022-07-16 07:05:38,2022-07-16 07:05:38,To GBP Rainy day,-5.00,0.00,GBP,COMPLETED,989.78
CARD_PAYMENT,Current,2022-07-16 01:28:03,2022-07-16 22:36:08,Transport for London,-5.20,0.00,GBP,COMPLETED,984.58
TRANSFER,Current,2022-07-17 07:05:24,2022-07-17 07:05:24,To GBP Rainy day,-5.00,0.00,GBP,COMPLETED,979.58
TRANSFER,Current,2022-07-17 12:15:26,2022-07-17 12:15:28,To Lingvo State Ltd,-640.00,0.00,GBP,COMPLETED,339.58
TRANSFER,Current,2022-07-18 07:24:44,2022-07-18 07:24:44,To GBP Rainy day,-5.00,0.00,GBP,COMPLETED,334.58
TRANSFER,Current,2022-07-18 08:34:43,2022-07-18 08:34:43,To GBP,164.76,0.00,GBP,COMPLETED,499.34
TRANSFER,Current,2022-07-18 08:35:01,2022-07-18 08:35:01,To GBP,1000.00,0.00,GBP,COMPLETED,1499.34
TRANSFER,Current,2022-07-18 22:58:47,2022-07-18 22:58:47,To GBP Rainy day,-3.00,0.00,GBP,COMPLETED,1496.34
TRANSFER,Current,2022-07-19 01:18:12,2022-07-19 01:18:12,To GBP Rainy day,-0.90,0.00,GBP,COMPLETED,1495.44
TRANSFER,Current,2022-07-19 07:04:56,2022-07-19 07:04:56,To GBP Rainy day,-5.00,0.00,GBP,COMPLETED,1490.44
CARD_PAYMENT,Current,2022-07-19 01:18:12,2022-07-19 11:03:56,Transport for London,-7.70,0.00,GBP,COMPLETED,1482.74
CARD_PAYMENT,Current,2022-07-18 22:58:47,2022-07-19 12:14:24,EE,-27.00,0.00,GBP,COMPLETED,1455.74
TRANSFER,Current,2022-07-20 07:05:29,2022-07-20 07:05:29,To GBP Rainy day,-5.00,0.00,GBP,COMPLETED,1450.74
TRANSFER,Current,2022-07-21 07:06:18,2022-07-21 07:06:18,To GBP Rainy day,-5.00,0.00,GBP,COMPLETED,1445.74
TRANSFER,Current,2022-07-21 23:01:00,2022-07-21 23:01:00,To GBP Rainy day,-3.00,0.00,GBP,COMPLETED,1442.74
TRANSFER,Current,2022-07-22 03:17:05,2022-07-22 03:17:05,To GBP Rainy day,-0.03,0.00,GBP,COMPLETED,1442.71
TRANSFER,Current,2022-07-22 07:08:26,2022-07-22 07:08:26,To GBP Rainy day,-5.00,0.00,GBP,COMPLETED,1437.71
CARD_PAYMENT,Current,2022-07-21 23:01:00,2022-07-22 13:11:16,EE,-18.00,0.00,GBP,COMPLETED,1419.71
CARD_PAYMENT,Current,2022-07-22 03:17:05,2022-07-22 22:54:26,Apple,-6.99,0.00,GBP,COMPLETED,1412.72
TRANSFER,Current,2022-07-23 01:26:15,2022-07-23 01:26:15,To GBP Rainy day,-1.80,0.00,GBP,COMPLETED,1410.92
TRANSFER,Current,2022-07-23 07:05:27,2022-07-23 07:05:27,To GBP Rainy day,-5.00,0.00,GBP,COMPLETED,1405.92
CARD_PAYMENT,Current,2022-07-23 01:26:15,2022-07-24 00:18:13,Transport for London,-3.40,0.00,GBP,COMPLETED,1402.52
TRANSFER,Current,2022-07-24 07:05:21,2022-07-24 07:05:21,To GBP Rainy day,-5.00,0.00,GBP,COMPLETED,1397.52
TRANSFER,Current,2022-07-24 23:37:00,2022-07-24 23:37:00,To GBP Rainy day,-0.66,0.00,GBP,COMPLETED,1396.86
TRANSFER,Current,2022-07-25 07:25:18,2022-07-25 07:25:18,To GBP Rainy day,-5.00,0.00,GBP,COMPLETED,1391.86
CARD_PAYMENT,Current,2022-07-24 23:37:00,2022-07-25 13:27:38,Myblu Uk,-90.78,0.00,GBP,COMPLETED,1301.08
TRANSFER,Current,2022-07-25 16:21:49,2022-07-25 16:21:56,To Mikhail Balabanov,-1000.00,0.00,GBP,COMPLETED,301.08
TRANSFER,Current,2022-07-26 07:05:21,2022-07-26 07:05:21,To GBP Rainy day,-5.00,0.00,GBP,COMPLETED,296.08
TRANSFER,Current,2022-07-27 01:27:39,2022-07-27 01:27:39,To GBP Rainy day,-2.40,0.00,GBP,COMPLETED,293.68
TRANSFER,Current,2022-07-27 13:04:47,2022-07-27 13:04:47,To GBP Rainy day,-5.00,0.00,GBP,COMPLETED,288.68
TOPUP,Current,2022-07-27 15:56:11,2022-07-27 15:56:26,Card Top-Up,1000.00,0.00,GBP,COMPLETED,1288.68
CARD_PAYMENT,Current,2022-07-27 01:27:38,2022-07-27 17:03:31,Transport for London,-5.20,0.00,GBP,COMPLETED,1283.48
TRANSFER,Current,2022-07-28 07:06:52,2022-07-28 07:06:52,To GBP Rainy day,-5.00,0.00,GBP,COMPLETED,1278.48
TRANSFER,Current,2022-07-28 10:15:01,2022-07-28 10:15:01,To GBP,2000.00,0.00,GBP,COMPLETED,3278.48
TRANSFER,Current,2022-07-29 01:00:00,2022-07-29 01:01:08,To Virgin Active,-139.99,0.00,GBP,COMPLETED,3138.49
TRANSFER,Current,2022-07-29 06:09:01,2022-07-29 06:09:01,To GBP Rainy day,-0.57,0.00,GBP,COMPLETED,3137.92
TRANSFER,Current,2022-07-29 07:08:43,2022-07-29 07:08:43,To GBP Rainy day,-5.00,0.00,GBP,COMPLETED,3132.92
TRANSFER,Current,2022-07-29 13:35:16,2022-07-29 13:35:16,To GBP Rainy day,-0.03,0.00,GBP,COMPLETED,3132.89
TRANSFER,Current,2022-07-30 03:07:55,2022-07-30 03:07:55,To GBP Rainy day,-3.00,0.00,GBP,COMPLETED,3129.89
TRANSFER,Current,2022-07-30 04:01:53,2022-07-30 04:01:53,To GBP Rainy day,-0.03,0.00,GBP,COMPLETED,3129.86
TRANSFER,Current,2022-07-30 07:06:01,2022-07-30 07:06:01,To GBP Rainy day,-5.00,0.00,GBP,COMPLETED,3124.86
TRANSFER,Current,2022-07-30 09:01:26,2022-07-30 09:01:33,To Holly Michael,-2450.00,0.00,GBP,COMPLETED,674.86
CARD_PAYMENT,Current,2022-07-29 13:35:12,2022-07-30 10:08:50,Amazon Prime,-7.99,0.00,GBP,COMPLETED,666.87
CARD_PAYMENT,Current,2022-07-29 06:09:01,2022-07-30 13:24:46,Waitrose,-205.81,0.00,GBP,COMPLETED,461.06
CARD_PAYMENT,Current,2022-07-30 04:01:53,2022-07-30 15:11:23,Netflix,-10.99,0.00,GBP,COMPLETED,450.07
TRANSFER,Current,2022-07-31 07:06:20,2022-07-31 07:06:20,To GBP Rainy day,-5.00,0.00,GBP,COMPLETED,445.07
CARD_PAYMENT,Current,2022-07-30 03:07:55,2022-07-31 11:41:49,Loqbox,-50.00,0.00,GBP,COMPLETED,395.07
TRANSFER,Current,2022-08-01 07:30:58,2022-08-01 07:30:58,To GBP Rainy day,-5.00,0.00,GBP,COMPLETED,390.07
TOPUP,Current,2022-08-01 19:46:24,2022-08-01 19:46:24,Payment from Balabanov M,2000.00,0.00,GBP,COMPLETED,2390.07
TOPUP,Current,2022-08-01 19:47:16,2022-08-01 19:47:16,Payment from Balabanov M,1000.00,0.00,GBP,COMPLETED,3390.07
TRANSFER,Current,2022-08-02 07:05:42,2022-08-02 07:05:42,To GBP Rainy day,-5.00,0.00,GBP,COMPLETED,3385.07
TRANSFER,Current,2022-08-02 07:41:24,2022-08-02 07:41:24,To Natalia Balabanova,-2000.00,0.00,GBP,COMPLETED,1385.07
TRANSFER,Current,2022-08-02 07:41:42,2022-08-02 07:41:42,To Aleksandra Balabanova,-600.00,0.00,GBP,COMPLETED,785.07
TRANSFER,Current,2022-08-02 09:01:34,2022-08-02 09:01:36,To Aleksandra Balabanova,-600.00,0.00,GBP,COMPLETED,185.07
TRANSFER,Current,2022-08-02 11:02:27,2022-08-02 11:02:33,From Aleksandra Balabanova,600.00,0.00,GBP,COMPLETED,785.07
TRANSFER,Current,2022-08-03 07:05:47,2022-08-03 07:05:47,To GBP Rainy day,-5.00,0.00,GBP,COMPLETED,780.07
TRANSFER,Current,2022-08-03 19:00:58,2022-08-03 19:00:58,To GBP Rainy day,-2.70,0.00,GBP,COMPLETED,777.37
TRANSFER,Current,2022-08-04 01:25:18,2022-08-04 01:25:18,To GBP Rainy day,-1.20,0.00,GBP,COMPLETED,776.17
TRANSFER,Current,2022-08-04 07:06:37,2022-08-04 07:06:37,To GBP Rainy day,-5.00,0.00,GBP,COMPLETED,771.17
TRANSFER,Current,2022-08-04 10:10:44,2022-08-04 10:10:44,To GBP Rainy day,-1.08,0.00,GBP,COMPLETED,770.09
TRANSFER,Current,2022-08-04 13:30:59,2022-08-04 13:30:59,To GBP,2500.00,0.00,GBP,COMPLETED,3270.09
TRANSFER,Current,2022-08-04 13:34:36,2022-08-04 13:34:42,To Sterling Startup Solutions Limited,-2500.00,0.00,GBP,COMPLETED,770.09
CARD_PAYMENT,Current,2022-08-04 01:25:17,2022-08-04 14:37:28,Transport for London,-1.60,0.00,GBP,COMPLETED,768.49
CARD_PAYMENT,Current,2022-08-03 19:00:58,2022-08-04 19:46:09,SticksnSushi,-54.10,0.00,GBP,COMPLETED,714.39
TRANSFER,Current,2022-08-05 07:09:22,2022-08-05 07:09:22,To GBP Rainy day,-5.00,0.00,GBP,COMPLETED,709.39
CARD_PAYMENT,Current,2022-08-04 10:10:44,2022-08-05 10:53:27,Amazon,-24.64,0.00,GBP,COMPLETED,684.75
TRANSFER,Current,2022-08-06 07:05:43,2022-08-06 07:05:43,Depositing savings,-5.00,0.00,GBP,COMPLETED,679.75
TRANSFER,Current,2022-08-06 11:08:20,2022-08-06 11:08:24,Depositing savings,-3.00,0.00,GBP,COMPLETED,676.75
TRANSFER,Current,2022-08-06 11:28:28,2022-08-06 11:28:28,Depositing savings,-3.00,0.00,GBP,COMPLETED,673.75
TRANSFER,Current,2022-08-06 11:30:34,2022-08-06 11:30:34,Depositing savings,-3.00,0.00,GBP,COMPLETED,670.75
TRANSFER,Current,2022-08-06 11:39:11,2022-08-06 11:39:12,Depositing savings,-0.03,0.00,GBP,COMPLETED,670.72
TRANSFER,Current,2022-08-06 16:36:56,2022-08-06 16:36:56,Withdrawing savings,1000.00,0.00,GBP,COMPLETED,1670.72
TRANSFER,Current,2022-08-06 16:38:42,2022-08-06 16:38:42,Depositing savings,-0.33,0.00,GBP,COMPLETED,1670.39
TRANSFER,Current,2022-08-07 01:19:38,2022-08-07 01:19:38,Depositing savings,-1.20,0.00,GBP,COMPLETED,1669.19
TRANSFER,Current,2022-08-07 07:05:36,2022-08-07 07:05:36,Depositing savings,-5.00,0.00,GBP,COMPLETED,1664.19
CARD_PAYMENT,Current,2022-08-06 16:38:42,2022-08-07 13:02:30,Pegasus Airlines,-740.89,0.00,GBP,COMPLETED,923.30
CARD_PAYMENT,Current,2022-08-07 01:19:38,2022-08-07 14:25:27,Transport for London,-2.60,0.00,GBP,COMPLETED,920.70
CARD_PAYMENT,Current,2022-08-06 11:30:34,2022-08-07 16:54:59,jet2.com,-30.00,0.00,GBP,COMPLETED,890.70
CARD_PAYMENT,Current,2022-08-06 11:08:20,2022-08-07 16:55:00,jet2.com,-117.00,0.00,GBP,COMPLETED,773.70
CARD_PAYMENT,Current,2022-08-06 11:28:27,2022-08-07 16:55:00,jet2.com,-43.00,0.00,GBP,COMPLETED,730.70
CARD_PAYMENT,Current,2022-08-06 11:39:10,2022-08-07 17:33:41,Apple,-14.99,0.00,GBP,COMPLETED,715.71
TRANSFER,Current,2022-08-07 20:16:18,2022-08-07 20:16:18,Depositing savings,-1.53,0.00,GBP,COMPLETED,714.18
TRANSFER,Current,2022-08-07 22:43:47,2022-08-07 22:43:47,Depositing savings,-3.00,0.00,GBP,COMPLETED,711.18
TRANSFER,Current,2022-08-08 07:26:20,2022-08-08 07:26:20,Depositing savings,-5.00,0.00,GBP,COMPLETED,706.18
CARD_PAYMENT,Current,2022-08-07 22:43:46,2022-08-08 12:56:41,EE,-25.00,0.00,GBP,COMPLETED,681.18
CARD_PAYMENT,Current,2022-08-07 20:16:18,2022-08-08 21:35:47,Apple,-3.49,0.00,GBP,COMPLETED,677.69
TRANSFER,Current,2022-08-09 07:05:03,2022-08-09 07:05:04,Depositing savings,-5.00,0.00,GBP,COMPLETED,672.69
TRANSFER,Current,2022-08-10 07:06:14,2022-08-10 07:06:14,Depositing savings,-5.00,0.00,GBP,COMPLETED,667.69
TRANSFER,Current,2022-08-10 07:30:13,2022-08-10 07:30:14,Withdrawing savings,2000.00,0.00,GBP,COMPLETED,2667.69
TRANSFER,Current,2022-08-10 07:41:42,2022-08-10 07:41:42,Depositing savings,-1.89,0.00,GBP,COMPLETED,2665.80
TRANSFER,Current,2022-08-10 09:00:41,2022-08-10 09:00:41,Depositing savings,-2.70,0.00,GBP,COMPLETED,2663.10
TRANSFER,Current,2022-08-10 11:30:20,2022-08-10 11:30:21,Depositing savings,-3.00,0.00,GBP,COMPLETED,2660.10
TRANSFER,Current,2022-08-11 07:06:37,2022-08-11 07:06:38,Depositing savings,-5.00,0.00,GBP,COMPLETED,2655.10
CARD_PAYMENT,Current,2022-08-10 09:00:40,2022-08-11 10:09:36,Ms Thestudenthotel T,-1486.10,0.00,GBP,COMPLETED,1169.00
TRANSFER,Current,2022-08-11 12:08:45,2022-08-11 12:08:45,Depositing savings,-0.03,0.00,GBP,COMPLETED,1168.97
CARD_PAYMENT,Current,2022-08-10 11:30:20,2022-08-11 14:29:43,Pegasus Airlines,-532.00,0.00,GBP,COMPLETED,636.97
TRANSFER,Current,2022-08-12 01:00:00,2022-08-12 01:03:35,To Billing Better,-182.82,0.00,GBP,COMPLETED,454.15
TRANSFER,Current,2022-08-12 01:23:45,2022-08-12 01:23:45,Depositing savings,-1.20,0.00,GBP,COMPLETED,452.95
TRANSFER,Current,2022-08-12 07:08:48,2022-08-12 07:08:49,Depositing savings,-5.00,0.00,GBP,COMPLETED,447.95
TRANSFER,Current,2022-08-12 09:25:25,2022-08-12 09:25:25,Withdrawing savings,1000.00,0.00,GBP,COMPLETED,1447.95
TRANSFER,Current,2022-08-12 10:07:17,2022-08-12 10:07:18,Depositing savings,-2.25,0.00,GBP,COMPLETED,1445.70
CARD_PAYMENT,Current,2022-08-10 07:41:42,2022-08-12 11:26:34,KLM Royal Dutch Airlines,-198.07,0.00,GBP,COMPLETED,1247.63
CARD_PAYMENT,Current,2022-08-10 01:00:00,2022-08-12 11:26:34,KLM Royal Dutch Airlines,-25.30,0.00,GBP,COMPLETED,1222.33
TRANSFER,Current,2022-08-12 11:26:34,2022-08-12 11:26:35,Depositing savings,-2.10,0.00,GBP,COMPLETED,1220.23
CARD_PAYMENT,Current,2022-08-12 01:23:44,2022-08-12 15:30:28,Transport for London,-2.60,0.00,GBP,COMPLETED,1217.63
CARD_PAYMENT,Current,2022-08-11 12:08:44,2022-08-12 21:00:02,Apple,-4.99,0.00,GBP,COMPLETED,1212.64
TRANSFER,Current,2022-08-13 07:05:34,2022-08-13 07:05:34,Depositing savings,-5.00,0.00,GBP,COMPLETED,1207.64
CARD_PAYMENT,Current,2022-08-12 10:07:17,2022-08-13 09:20:09,tickets,-718.25,0.00,GBP,COMPLETED,489.39
TRANSFER,Current,2022-08-13 23:30:45,2022-08-13 23:30:45,Depositing savings,-3.00,0.00,GBP,COMPLETED,486.39
TRANSFER,Current,2022-08-14 07:05:23,2022-08-14 07:05:27,Depositing savings,-5.00,0.00,GBP,COMPLETED,481.39
TRANSFER,Current,2022-08-15 07:27:25,2022-08-15 07:27:25,Depositing savings,-5.00,0.00,GBP,COMPLETED,476.39
CARD_PAYMENT,Current,2022-08-13 23:30:45,2022-08-15 10:27:18,Amazon,-18.00,0.00,GBP,COMPLETED,458.39
TRANSFER,Current,2022-08-15 11:51:40,2022-08-15 11:51:40,Depositing savings,-1.95,0.00,GBP,COMPLETED,456.44
TRANSFER,Current,2022-08-16 01:22:26,2022-08-16 01:22:27,Depositing savings,-1.80,0.00,GBP,COMPLETED,454.64
TRANSFER,Current,2022-08-16 07:05:15,2022-08-16 07:05:15,Depositing savings,-5.00,0.00,GBP,COMPLETED,449.64
CARD_PAYMENT,Current,2022-08-16 01:22:26,2022-08-16 17:55:44,Transport for London,-3.40,0.00,GBP,COMPLETED,446.24
CARD_PAYMENT,Current,2022-08-15 11:47:45,2022-08-16 19:56:34,name.com,-15.35,0.00,GBP,COMPLETED,430.89
TRANSFER,Current,2022-08-17 01:24:45,2022-08-17 01:24:45,Depositing savings,-2.40,0.00,GBP,COMPLETED,428.49
TRANSFER,Current,2022-08-17 07:05:22,2022-08-17 07:05:22,Depositing savings,-5.00,0.00,GBP,COMPLETED,423.49
TRANSFER,Current,2022-08-17 11:24:48,2022-08-17 11:25:19,Depositing savings,-1.08,0.00,GBP,COMPLETED,422.41
CARD_PAYMENT,Current,2022-08-17 01:24:45,2022-08-17 13:57:12,Transport for London,-5.20,0.00,GBP,COMPLETED,417.21
TRANSFER,Current,2022-08-17 22:52:54,2022-08-17 22:52:54,Depositing savings,-3.00,0.00,GBP,COMPLETED,414.21
TRANSFER,Current,2022-08-18 01:24:02,2022-08-18 01:24:06,Depositing savings,-1.80,0.00,GBP,COMPLETED,412.41
TRANSFER,Current,2022-08-18 07:06:31,2022-08-18 07:06:32,Depositing savings,-5.00,0.00,GBP,COMPLETED,407.41
CARD_PAYMENT,Current,2022-08-17 11:24:48,2022-08-18 09:05:34,Wholefood Earth,-89.64,0.00,GBP,COMPLETED,317.77
CARD_PAYMENT,Current,2022-08-17 22:52:54,2022-08-18 11:26:48,EE,-27.00,0.00,GBP,COMPLETED,290.77
TRANSFER,Current,2022-08-18 11:55:30,2022-08-18 11:55:31,Depositing savings,-3.00,0.00,GBP,COMPLETED,287.77
CARD_PAYMENT,Current,2022-08-18 01:24:02,2022-08-18 13:50:53,Transport for London,-3.40,0.00,GBP,COMPLETED,284.37
TRANSFER,Current,2022-08-18 21:50:52,2022-08-18 21:50:52,Depositing savings,-0.03,0.00,GBP,COMPLETED,284.34
TRANSFER,Current,2022-08-19 07:08:37,2022-08-19 07:08:38,Depositing savings,-5.00,0.00,GBP,COMPLETED,279.34
CARD_PAYMENT,Current,2022-08-18 11:55:30,2022-08-19 10:39:57,Amazon,-119.00,0.00,GBP,COMPLETED,160.34
CARD_PAYMENT,Current,2022-08-18 21:50:51,2022-08-19 21:46:57,Apple,-13.99,0.00,GBP,COMPLETED,146.35
TRANSFER,Current,2022-08-20 01:11:44,2022-08-20 01:11:44,Depositing savings,-0.75,0.00,GBP,COMPLETED,145.60
TRANSFER,Current,2022-08-20 07:05:50,2022-08-20 07:05:51,Depositing savings,-5.00,0.00,GBP,COMPLETED,140.60
TRANSFER,Current,2022-08-19 21:55:57,2022-08-20 09:08:23,To Artem Aleshkin,-10.00,0.00,GBP,COMPLETED,130.60
CARD_PAYMENT,Current,2022-08-20 01:11:43,2022-08-20 14:25:12,Transport for London,-5.75,0.00,GBP,COMPLETED,124.85
TRANSFER,Current,2022-08-20 22:53:19,2022-08-20 22:53:19,Depositing savings,-3.00,0.00,GBP,COMPLETED,121.85
TRANSFER,Current,2022-08-21 07:05:25,2022-08-21 07:05:26,Depositing savings,-5.00,0.00,GBP,COMPLETED,116.85
CARD_PAYMENT,Current,2022-08-20 22:53:18,2022-08-21 11:49:58,EE,-18.00,0.00,GBP,COMPLETED,98.85
TRANSFER,Current,2022-08-22 03:17:25,2022-08-22 03:17:25,Depositing savings,-0.03,0.00,GBP,COMPLETED,98.82
TRANSFER,Current,2022-08-22 07:26:56,2022-08-22 07:26:59,Depositing savings,-5.00,0.00,GBP,COMPLETED,93.82
TRANSFER,Current,2022-08-22 17:28:39,2022-08-22 17:28:40,Depositing savings,-1.20,0.00,GBP,COMPLETED,92.62
TRANSFER,Current,2022-08-22 17:46:33,2022-08-22 17:46:33,Depositing savings,-3.00,0.00,GBP,COMPLETED,89.62
TOPUP,Current,2022-08-23 01:00:03,2022-08-23 01:00:04,Payment from Balabanov M,3750.00,0.00,GBP,COMPLETED,3839.62
TRANSFER,Current,2022-08-23 01:01:15,2022-08-23 01:01:15,To Artem Aleshkin,-3750.00,0.00,GBP,COMPLETED,89.62
TRANSFER,Current,2022-08-23 01:18:18,2022-08-23 01:18:18,Depositing savings,-1.80,0.00,GBP,COMPLETED,87.82
TRANSFER,Current,2022-08-23 07:05:04,2022-08-23 07:05:04,Depositing savings,-5.00,0.00,GBP,COMPLETED,82.82
CARD_PAYMENT,Current,2022-08-23 01:18:17,2022-08-23 14:18:36,Transport for London,-6.40,0.00,GBP,COMPLETED,76.42
EXCHANGE,Current,2022-08-23 14:47:20,2022-08-23 14:47:20,Exchanged to GBP,711925.83,0.00,GBP,COMPLETED,712002.25
TRANSFER,Current,2022-08-23 15:17:45,2022-08-23 15:17:50,Depositing savings,-10000.00,0.00,GBP,COMPLETED,702002.25
TRANSFER,Current,2022-08-23 15:37:18,2022-08-23 15:37:25,To Mikhail Balabanov,-100000.00,0.00,GBP,COMPLETED,602002.25
TRANSFER,Current,2022-08-23 15:59:08,2022-08-23 15:59:15,To Mikhail Balabanov,-200000.00,0.00,GBP,COMPLETED,402002.25
TOPUP,Current,2022-08-23 16:42:33,2022-08-23 16:42:33,Payment from Balabanov M,2300.00,0.00,GBP,COMPLETED,404302.25
CARD_PAYMENT,Current,2022-08-22 03:17:25,2022-08-23 17:16:08,Apple,-6.99,0.00,GBP,COMPLETED,404295.26
TRANSFER,Current,2022-08-24 01:20:51,2022-08-24 01:20:55,Depositing savings,-1.80,0.00,GBP,COMPLETED,404293.46
TRANSFER,Current,2022-08-24 07:05:18,2022-08-24 07:05:21,Depositing savings,-5.00,0.00,GBP,COMPLETED,404288.46
CARD_PAYMENT,Current,2022-08-22 17:46:33,2022-08-24 12:31:29,No 35 Mackenzie Walk,-7.00,0.00,GBP,COMPLETED,404281.46
CARD_PAYMENT,Current,2022-08-22 17:28:39,2022-08-24 12:31:29,No 35 Mackenzie Walk,-13.60,0.00,GBP,COMPLETED,404267.86
CARD_PAYMENT,Current,2022-08-24 01:20:51,2022-08-24 15:48:44,Transport for London,-3.40,0.00,GBP,COMPLETED,404264.46
TRANSFER,Current,2022-08-25 01:21:31,2022-08-25 01:21:32,Depositing savings,-2.10,0.00,GBP,COMPLETED,404262.36
TRANSFER,Current,2022-08-25 07:06:53,2022-08-25 07:06:54,Depositing savings,-5.00,0.00,GBP,COMPLETED,404257.36
CARD_PAYMENT,Current,2022-08-25 01:21:31,2022-08-25 15:20:53,Transport for London,-4.30,0.00,GBP,COMPLETED,404253.06
TRANSFER,Current,2022-08-26 01:21:40,2022-08-26 01:21:41,Depositing savings,-1.20,0.00,GBP,COMPLETED,404251.86
TRANSFER,Current,2022-08-26 07:09:08,2022-08-26 07:09:08,Depositing savings,-5.00,0.00,GBP,COMPLETED,404246.86
TRANSFER,Current,2022-08-26 14:56:15,,Depositing savings,-400000.00,0.00,GBP,REVERTED,
TRANSFER,Current,2022-08-26 14:56:37,,Depositing savings,-400000.00,0.00,GBP,REVERTED,
TRANSFER,Current,2022-08-26 14:58:33,2022-08-26 14:58:33,To GBP Home,-400000.00,0.00,GBP,COMPLETED,4246.86
EXCHANGE,Current,2022-08-26 15:01:02,2022-08-26 15:01:02,Exchanged to EUR,-1696.07,0.00,GBP,COMPLETED,2550.79
CARD_PAYMENT,Current,2022-08-26 01:21:40,2022-08-26 15:01:12,Transport for London,-1.60,0.00,GBP,COMPLETED,2549.19
TRANSFER,Current,2022-08-27 07:05:54,2022-08-27 07:05:59,Depositing savings,-5.00,0.00,GBP,COMPLETED,2544.19
TRANSFER,Current,2022-08-28 07:06:01,2022-08-28 07:06:01,Depositing savings,-5.00,0.00,GBP,COMPLETED,2539.19
REFUND,Current,2022-08-28 15:56:58,2022-08-28 15:56:59,Plan termination refund,54.00,0.00,GBP,COMPLETED,2593.19
FEE,Current,2022-08-28 15:56:59,2022-08-28 15:56:59,Metal plan fee,-12.99,0.00,GBP,COMPLETED,2580.20
TRANSFER,Current,2022-08-28 15:58:21,2022-08-28 15:58:21,To GBP,85000.00,0.00,GBP,COMPLETED,87580.20
TRANSFER,Current,2022-08-28 15:58:32,,Depositing savings,-85000.00,0.00,GBP,REVERTED,
TRANSFER,Current,2022-08-28 15:58:50,,Depositing savings,-80000.00,0.00,GBP,REVERTED,
TRANSFER,Current,2022-08-28 15:59:39,2022-08-28 15:59:39,To GBP Home,-85000.00,0.00,GBP,COMPLETED,2580.20
TRANSFER,Current,2022-08-28 18:14:06,2022-08-28 18:14:06,Depositing savings,-3.00,0.00,GBP,COMPLETED,2577.20
TRANSFER,Current,2022-08-29 07:27:35,2022-08-29 07:27:36,Depositing savings,-5.00,0.00,GBP,COMPLETED,2572.20
TRANSFER,Current,2022-08-29 09:11:19,2022-08-29 09:11:25,Depositing savings,-0.36,0.00,GBP,COMPLETED,2571.84
TRANSFER,Current,2022-08-29 10:40:35,2022-08-29 10:40:35,Depositing savings,-1.20,0.00,GBP,COMPLETED,2570.64
TRANSFER,Current,2022-08-29 11:33:40,2022-08-29 11:33:57,Depositing savings,-3.00,0.00,GBP,COMPLETED,2567.64
TRANSFER,Current,2022-08-29 11:37:27,2022-08-29 11:37:32,Depositing savings,-0.45,0.00,GBP,COMPLETED,2567.19
TRANSFER,Current,2022-08-29 11:39:56,2022-08-29 11:39:59,Depositing savings,-0.45,0.00,GBP,COMPLETED,2566.74
TRANSFER,Current,2022-08-29 11:46:21,2022-08-29 11:46:26,Depositing savings,-2.70,0.00,GBP,COMPLETED,2564.04
CARD_PAYMENT,Current,2022-08-28 18:14:05,2022-08-29 12:06:50,Westfield Stratford City,-6.00,0.00,GBP,COMPLETED,2558.04
TRANSFER,Current,2022-08-29 13:44:20,2022-08-29 13:44:24,Depositing savings,-0.03,0.00,GBP,COMPLETED,2558.01
TRANSFER,Current,2022-08-29 14:32:42,2022-08-29 14:33:03,Depositing savings,-0.09,0.00,GBP,COMPLETED,2557.92
TRANSFER,Current,2022-08-29 16:13:35,2022-08-29 16:13:38,Depositing savings,-2.70,0.00,GBP,COMPLETED,2555.22
TRANSFER,Current,2022-08-29 16:30:22,2022-08-29 16:30:25,Depositing savings,-0.60,0.00,GBP,COMPLETED,2554.62
TRANSFER,Current,2022-08-29 16:55:02,2022-08-29 16:55:03,Depositing savings,-1.50,0.00,GBP,COMPLETED,2553.12
TRANSFER,Current,2022-08-29 17:27:43,2022-08-29 17:28:21,Depositing savings,-3.00,0.00,GBP,COMPLETED,2550.12
TRANSFER,Current,2022-08-29 17:58:04,2022-08-29 17:58:08,Depositing savings,-1.98,0.00,GBP,COMPLETED,2548.14
TRANSFER,Current,2022-08-29 19:48:05,2022-08-29 19:48:06,Depositing savings,-1.50,0.00,GBP,COMPLETED,2546.64
TRANSFER,Current,2022-08-30 03:06:25,2022-08-30 03:06:26,Depositing savings,-3.00,0.00,GBP,COMPLETED,2543.64
TRANSFER,Current,2022-08-30 05:00:21,2022-08-30 05:00:24,Depositing savings,-0.03,0.00,GBP,COMPLETED,2543.61
TRANSFER,Current,2022-08-30 07:05:39,2022-08-30 07:05:40,Depositing savings,-5.00,0.00,GBP,COMPLETED,2538.61
TRANSFER,Current,2022-08-30 09:39:54,2022-08-30 09:39:54,Withdrawing savings,1500.00,0.00,GBP,COMPLETED,4038.61
TRANSFER,Current,2022-08-30 09:40:53,2022-08-30 09:40:58,To Holly Michael,-2450.00,0.00,GBP,COMPLETED,1588.61
CARD_PAYMENT,Current,2022-08-29 13:44:10,2022-08-30 09:47:10,Amazon Prime,-7.99,0.00,GBP,COMPLETED,1580.62
TRANSFER,Current,2022-08-30 09:48:10,2022-08-30 09:48:13,Depositing savings,-1.95,0.00,GBP,COMPLETED,1578.67
TRANSFER,Current,2022-08-30 09:51:53,2022-08-30 09:51:56,Depositing savings,-0.06,0.00,GBP,COMPLETED,1578.61
CARD_PAYMENT,Current,2022-08-29 16:28:52,2022-08-30 09:55:05,Calvin Klein,-29.80,0.00,GBP,COMPLETED,1548.81
CARD_PAYMENT,Current,2022-08-29 14:32:03,2022-08-30 10:37:45,Amazon,-67.97,0.00,GBP,COMPLETED,1480.84
CARD_PAYMENT,Current,2022-08-29 11:46:20,2022-08-30 10:54:35,Tesco,-7.10,0.00,GBP,COMPLETED,1473.74
CARD_PAYMENT,Current,2022-08-29 16:54:57,2022-08-30 11:15:16,Ashford,-94.50,0.00,GBP,COMPLETED,1379.24
CARD_PAYMENT,Current,2022-08-29 11:33:40,2022-08-30 12:00:02,Adam Grooming Atelier,-30.00,0.00,GBP,COMPLETED,1349.24
TRANSFER,Current,2022-08-30 12:11:39,2022-08-30 12:11:39,Depositing savings,-1.95,0.00,GBP,COMPLETED,1347.29
CARD_PAYMENT,Current,2022-08-29 17:58:04,2022-08-30 12:25:23,Asda,-49.34,0.00,GBP,COMPLETED,1297.95
CARD_PAYMENT,Current,2022-08-29 10:39:37,2022-08-30 12:25:41,Starbucks,-3.60,0.00,GBP,COMPLETED,1294.35
CARD_PAYMENT,Current,2022-08-29 19:48:04,2022-08-30 12:32:45,B&Q,-6.50,0.00,GBP,COMPLETED,1287.85
CARD_PAYMENT,Current,2022-08-29 17:27:43,2022-08-30 13:33:40,Mcarthurglen Ashford Park,-2.00,0.00,GBP,COMPLETED,1285.85
TRANSFER,Current,2022-08-30 13:42:23,2022-08-30 13:42:35,Depositing savings,-1.50,0.00,GBP,COMPLETED,1284.35
TRANSFER,Current,2022-08-30 13:59:44,2022-08-30 13:59:44,Depositing savings,-3.00,0.00,GBP,COMPLETED,1281.35
CARD_PAYMENT,Current,2022-08-29 11:37:22,2022-08-30 14:13:38,PAUL,-15.85,0.00,GBP,COMPLETED,1265.50
CARD_PAYMENT,Current,2022-08-29 16:13:32,2022-08-30 14:16:01,Jack Wills,-32.10,0.00,GBP,COMPLETED,1233.40
CARD_PAYMENT,Current,2022-08-30 05:00:21,2022-08-30 15:10:32,Netflix,-10.99,0.00,GBP,COMPLETED,1222.41
CARD_PAYMENT,Current,2022-08-29 09:11:18,2022-08-30 15:22:53,IKEA,-581.88,0.00,GBP,COMPLETED,640.53
TRANSFER,Current,2022-08-30 15:59:03,2022-08-30 15:59:03,Depositing savings,-0.90,0.00,GBP,COMPLETED,639.63
TRANSFER,Current,2022-08-30 16:34:54,2022-08-30 16:34:57,Withdrawing savings,700.00,0.00,GBP,COMPLETED,1339.63
TRANSFER,Current,2022-08-30 16:40:59,2022-08-30 19:04:20,To ORANGE HOMES,-676.66,0.00,GBP,COMPLETED,662.97
TRANSFER,Current,2022-08-30 20:26:12,2022-08-30 20:26:21,Depositing savings,-2.55,0.00,GBP,COMPLETED,660.42
TRANSFER,Current,2022-08-31 01:00:00,2022-08-31 01:01:14,To Virgin Active,-139.99,0.00,GBP,COMPLETED,520.43
TRANSFER,Current,2022-08-31 01:20:46,2022-08-31 01:20:46,Depositing savings,-1.20,0.00,GBP,COMPLETED,519.23
TRANSFER,Current,2022-08-31 07:02:37,2022-08-31 07:02:38,Depositing savings,-2.67,0.00,GBP,COMPLETED,516.56
TRANSFER,Current,2022-08-31 07:06:20,2022-08-31 07:06:21,Depositing savings,-5.00,0.00,GBP,COMPLETED,511.56
CARD_PAYMENT,Current,2022-08-30 09:51:11,2022-08-31 10:35:19,News On The Wharf,-16.98,0.00,GBP,COMPLETED,494.58
CARD_PAYMENT,Current,2022-08-30 03:06:25,2022-08-31 11:15:02,Loqbox,-50.00,0.00,GBP,COMPLETED,444.58
TRANSFER,Current,2022-08-31 11:37:18,2022-08-31 11:38:36,Withdrawing savings,1000.00,0.00,GBP,COMPLETED,1444.58
TRANSFER,Current,2022-08-31 11:39:47,2022-08-31 11:39:48,Depositing savings,-2.52,0.00,GBP,COMPLETED,1442.06
CARD_PAYMENT,Current,2022-08-30 12:10:44,2022-08-31 12:48:32,Starbucks,-3.35,0.00,GBP,COMPLETED,1438.71
CARD_PAYMENT,Current,2022-08-30 09:47:44,2022-08-31 12:48:32,Starbucks,-3.35,0.00,GBP,COMPLETED,1435.36
CARD_PAYMENT,Current,2022-08-30 15:58:54,2022-08-31 13:12:55,Pret,-1.70,0.00,GBP,COMPLETED,1433.66
CARD_PAYMENT,Current,2022-08-31 01:20:45,2022-08-31 15:13:10,Transport for London,-1.60,0.00,GBP,COMPLETED,1432.06
CARD_PAYMENT,Current,2022-08-30 20:26:06,2022-08-31 15:22:44,Sainsbury's,-30.15,0.00,GBP,COMPLETED,1401.91
TRANSFER,Current,2022-08-31 19:07:32,2022-08-31 19:07:36,Depositing savings,-1.35,0.00,GBP,COMPLETED,1400.56
TRANSFER,Current,2022-08-31 19:28:46,2022-08-31 19:29:52,Depositing savings,-1.65,0.00,GBP,COMPLETED,1398.91
TRANSFER,Current,2022-08-31 19:29:09,2022-08-31 19:30:16,Depositing savings,-1.65,0.00,GBP,COMPLETED,1397.26
TRANSFER,Current,2022-08-31 19:49:55,2022-08-31 19:49:59,Depositing savings,-0.60,0.00,GBP,COMPLETED,1396.66
CARD_PAYMENT,Current,2022-08-30 13:42:23,2022-08-31 23:49:21,Level39,-3.50,0.00,GBP,COMPLETED,1393.16
TRANSFER,Current,2022-09-01 05:37:57,2022-09-01 05:37:57,Depositing savings,-2.73,0.00,GBP,COMPLETED,1390.43
TRANSFER,Current,2022-09-01 06:08:46,2022-09-01 06:08:46,Depositing savings,-1.65,0.00,GBP,COMPLETED,1388.78
TRANSFER,Current,2022-09-01 06:40:37,2022-09-01 06:40:37,Depositing savings,-0.03,0.00,GBP,COMPLETED,1388.75
TRANSFER,Current,2022-09-01 07:12:12,2022-09-01 07:12:12,Depositing savings,-5.00,0.00,GBP,COMPLETED,1383.75
TRANSFER,Current,2022-09-01 09:28:04,2022-09-01 09:28:04,To GBP,34000.00,0.00,GBP,COMPLETED,35383.75
TRANSFER,Current,2022-09-01 09:28:16,,Depositing savings,-34000.00,0.00,GBP,REVERTED,
TRANSFER,Current,2022-09-01 09:28:34,2022-09-01 09:28:35,Depositing savings,-30000.00,0.00,GBP,COMPLETED,5383.75
TRANSFER,Current,2022-09-01 09:28:46,2022-09-01 09:28:46,To GBP Home,-4000.00,0.00,GBP,COMPLETED,1383.75
TOPUP,Current,2022-09-01 09:30:54,2022-09-01 09:30:54,Payment from Balabanov M,5000.00,0.00,GBP,COMPLETED,6383.75
TRANSFER,Current,2022-09-01 11:14:21,2022-09-01 11:14:22,Depositing savings,-0.18,0.00,GBP,COMPLETED,6383.57
CARD_PAYMENT,Current,2022-08-31 19:28:43,2022-09-01 11:20:58,Hazev Restaurant,-3.45,0.00,GBP,COMPLETED,6380.12
CARD_PAYMENT,Current,2022-08-31 19:07:12,2022-09-01 11:20:58,Hazev Restaurant,-42.55,0.00,GBP,COMPLETED,6337.57
TRANSFER,Current,2022-09-01 12:28:38,2022-09-01 12:28:39,Depositing savings,-1.26,0.00,GBP,COMPLETED,6336.31
CARD_PAYMENT,Current,2022-08-31 07:02:36,2022-09-01 15:03:03,Waitrose,-200.11,0.00,GBP,COMPLETED,6136.20
TRANSFER,Current,2022-09-01 15:03:41,2022-09-01 15:03:45,Depositing savings,-0.51,0.00,GBP,COMPLETED,6135.69
CARD_PAYMENT,Current,2022-08-31 19:49:55,2022-09-01 15:05:25,Canary Wharf,-3.80,0.00,GBP,COMPLETED,6131.89
TRANSFER,Current,2022-09-01 17:41:33,2022-09-01 17:41:37,Depositing savings,-0.81,0.00,GBP,COMPLETED,6131.08
TRANSFER,Current,2022-09-02 07:09:27,2022-09-02 07:09:28,Depositing savings,-5.00,0.00,GBP,COMPLETED,6126.08
TRANSFER,Current,2022-09-02 09:02:10,2022-09-02 09:02:11,To Aleksandra Balabanova,-600.00,0.00,GBP,COMPLETED,5526.08
TRANSFER,Current,2022-09-02 09:02:10,2022-09-02 09:02:11,To Natalia Balabanova,-2000.00,0.00,GBP,COMPLETED,3526.08
CARD_PAYMENT,Current,2022-08-31 11:39:47,2022-09-02 09:46:23,Coolblue,-449.16,0.00,GBP,COMPLETED,3076.92
CARD_PAYMENT,Current,2022-08-30 13:59:43,2022-09-02 11:45:12,British Airways,-65.00,0.00,GBP,COMPLETED,3011.92
TRANSFER,Current,2022-09-02 12:29:06,2022-09-02 12:29:06,Depositing savings,-0.84,0.00,GBP,COMPLETED,3011.08
CARD_PAYMENT,Current,2022-09-01 06:08:45,2022-09-02 13:53:04,Pret,-3.45,0.00,GBP,COMPLETED,3007.63
CARD_PAYMENT,Current,2022-09-01 11:14:17,2022-09-02 14:39:58,Maxi Maki,-30.94,0.00,GBP,COMPLETED,2976.69
CARD_PAYMENT,Current,2022-09-01 12:28:34,2022-09-02 14:42:09,Maxi Maki,-32.58,0.00,GBP,COMPLETED,2944.11
CARD_PAYMENT,Current,2022-09-01 15:03:40,2022-09-02 14:46:13,IKEA,-270.83,0.00,GBP,COMPLETED,2673.28
CARD_PAYMENT,Current,2022-09-01 17:41:32,2022-09-02 14:48:05,Maxi Maki,-50.73,0.00,GBP,COMPLETED,2622.55
CARD_PAYMENT,Current,2022-09-01 05:37:57,2022-09-02 15:54:24,WHSmith,-23.09,0.00,GBP,COMPLETED,2599.46
CARD_PAYMENT,Current,2022-09-01 06:40:36,2022-09-02 15:54:24,WHSmith,-1.99,0.00,GBP,COMPLETED,2597.47
TRANSFER,Current,2022-09-02 18:23:28,2022-09-02 18:23:49,Depositing savings,-1.89,0.00,GBP,COMPLETED,2595.58
TRANSFER,Current,2022-09-02 18:59:49,2022-09-02 18:59:51,Depositing savings,-0.09,0.00,GBP,COMPLETED,2595.49
TRANSFER,Current,2022-09-02 19:11:55,2022-09-02 19:11:59,Depositing savings,-3.00,0.00,GBP,COMPLETED,2592.49
TRANSFER,Current,2022-09-03 07:06:07,2022-09-03 07:06:08,Depositing savings,-5.00,0.00,GBP,COMPLETED,2587.49
TRANSFER,Current,2022-09-03 11:45:41,2022-09-03 11:45:45,Depositing savings,-1.98,0.00,GBP,COMPLETED,2585.51
CARD_PAYMENT,Current,2022-09-02 12:29:06,2022-09-03 12:28:53,Maxi Maki,-25.72,0.00,GBP,COMPLETED,2559.79
CARD_PAYMENT,Current,2022-09-02 18:50:59,2022-09-03 12:38:03,Gamma,-88.00,0.00,GBP,COMPLETED,2471.79
CARD_PAYMENT,Current,2022-09-02 18:59:45,2022-09-03 12:38:03,Maxi Maki,-12.97,0.00,GBP,COMPLETED,2458.82
TRANSFER,Current,2022-09-03 13:26:43,2022-09-03 13:26:43,Depositing savings,-0.48,0.00,GBP,COMPLETED,2458.34
TRANSFER,Current,2022-09-03 14:38:21,2022-09-03 14:38:28,To Hunters West Hampstead Client Account,-800.00,0.00,GBP,COMPLETED,1658.34
CARD_PAYMENT,Current,2022-09-02 18:21:45,2022-09-03 14:42:13,TotalEnergies,-7.37,0.00,GBP,COMPLETED,1650.97
TRANSFER,Current,2022-09-03 15:19:14,2022-09-03 15:19:15,Depositing savings,-2.67,0.00,GBP,COMPLETED,1648.30
TRANSFER,Current,2022-09-03 16:11:36,2022-09-03 16:11:41,Depositing savings,-2.22,0.00,GBP,COMPLETED,1646.08
TRANSFER,Current,2022-09-03 16:35:44,2022-09-03 16:35:44,Depositing savings,-0.93,0.00,GBP,COMPLETED,1645.15
TRANSFER,Current,2022-09-03 17:10:50,2022-09-03 17:10:51,Depositing savings,-2.49,0.00,GBP,COMPLETED,1642.66
TRANSFER,Current,2022-09-03 18:04:32,2022-09-03 18:04:33,Depositing savings,-1.86,0.00,GBP,COMPLETED,1640.80
TRANSFER,Current,2022-09-03 18:18:54,2022-09-03 18:18:54,Depositing savings,-2.01,0.00,GBP,COMPLETED,1638.79
TRANSFER,Current,2022-09-03 21:05:53,2022-09-03 21:05:53,Depositing savings,-2.73,0.00,GBP,COMPLETED,1636.06
TRANSFER,Current,2022-09-03 21:59:58,2022-09-03 21:59:58,Depositing savings,-0.03,0.00,GBP,COMPLETED,1636.03
TRANSFER,Current,2022-09-04 01:17:32,2022-09-04 01:17:33,Depositing savings,-0.60,0.00,GBP,COMPLETED,1635.43
TRANSFER,Current,2022-09-04 07:05:45,2022-09-04 07:05:46,Depositing savings,-5.00,0.00,GBP,COMPLETED,1630.43
CARD_PAYMENT,Current,2022-09-03 16:35:43,2022-09-04 10:48:22,HMSHost International,-2.69,0.03,GBP,COMPLETED,1627.71
CARD_PAYMENT,Current,2022-09-03 16:11:36,2022-09-04 10:48:22,HMSHost International,-3.26,0.03,GBP,COMPLETED,1624.42
CARD_PAYMENT,Current,2022-09-03 18:04:32,2022-09-04 12:01:16,HMSHost International,-20.38,0.20,GBP,COMPLETED,1603.84
CARD_PAYMENT,Current,2022-09-03 18:18:51,2022-09-04 12:01:16,HMSHost International,-6.33,0.06,GBP,COMPLETED,1597.45
CARD_PAYMENT,Current,2022-09-03 21:59:58,2022-09-04 13:09:59,Whistlestop,-0.99,0.00,GBP,COMPLETED,1596.46
CARD_PAYMENT,Current,2022-09-03 21:05:52,2022-09-04 13:40:38,Heathrow Airport,-23.09,0.00,GBP,COMPLETED,1573.37
CARD_PAYMENT,Current,2022-09-03 13:26:42,2022-09-04 14:07:23,TotalEnergies,-12.84,0.13,GBP,COMPLETED,1560.40
CARD_PAYMENT,Current,2022-09-03 15:19:14,2022-09-04 14:08:27,NS,-9.11,0.09,GBP,COMPLETED,1551.20
CARD_PAYMENT,Current,2022-09-03 11:45:41,2022-09-04 14:57:08,Maxi Maki,-11.34,0.11,GBP,COMPLETED,1539.75
CARD_PAYMENT,Current,2022-09-03 17:10:50,2022-09-04 15:12:23,Schiphol,-3.17,0.03,GBP,COMPLETED,1536.55
TRANSFER,Current,2022-09-04 15:42:47,2022-09-04 15:42:47,Depositing savings,-1.50,0.00,GBP,COMPLETED,1535.05
TRANSFER,Current,2022-09-04 16:46:22,2022-09-04 16:46:23,Depositing savings,-3.00,0.00,GBP,COMPLETED,1532.05
TRANSFER,Current,2022-09-04 18:35:57,2022-09-04 18:35:57,Depositing savings,-3.00,0.00,GBP,COMPLETED,1529.05
TRANSFER,Current,2022-09-05 07:28:36,2022-09-05 07:28:36,Depositing savings,-5.00,0.00,GBP,COMPLETED,1524.05
TRANSFER,Current,2022-09-05 08:26:16,2022-09-05 08:26:16,Depositing savings,-1.95,0.00,GBP,COMPLETED,1522.10
CARD_PAYMENT,Current,2022-09-04 01:17:32,2022-09-05 09:14:57,Transport for London,-10.80,0.00,GBP,COMPLETED,1511.30
TRANSFER,Current,2022-09-05 09:48:29,2022-09-05 09:48:33,Depositing savings,-1.95,0.00,GBP,COMPLETED,1509.35
TRANSFER,Current,2022-09-05 09:52:02,2022-09-05 09:52:03,Depositing savings,-0.03,0.00,GBP,COMPLETED,1509.32
CARD_PAYMENT,Current,2022-09-04 18:35:56,2022-09-05 12:57:48,London Borough,-65.00,0.00,GBP,COMPLETED,1444.32
CARD_PAYMENT,Current,2022-09-04 15:42:46,2022-09-05 13:01:15,The Gallery,-38.50,0.00,GBP,COMPLETED,1405.82
TRANSFER,Current,2022-09-05 13:09:33,2022-09-05 13:09:34,Depositing savings,-2.10,0.00,GBP,COMPLETED,1403.72
CARD_PAYMENT,Current,2022-09-04 16:46:22,2022-09-05 13:19:38,Finchley Convenience Stor,-16.00,0.00,GBP,COMPLETED,1387.72
TRANSFER,Current,2022-09-05 15:52:42,2022-09-05 15:52:42,Depositing savings,-1.20,0.00,GBP,COMPLETED,1386.52
TRANSFER,Current,2022-09-05 17:47:58,2022-09-05 17:47:59,Depositing savings,-0.27,0.00,GBP,COMPLETED,1386.25
TRANSFER,Current,2022-09-05 18:52:11,2022-09-05 18:52:11,Depositing savings,-3.00,0.00,GBP,COMPLETED,1383.25
TRANSFER,Current,2022-09-05 19:36:06,2022-09-05 19:36:06,Depositing savings,-3.00,0.00,GBP,COMPLETED,1380.25
TRANSFER,Current,2022-09-05 20:18:47,2022-09-05 20:18:48,Depositing savings,-1.29,0.00,GBP,COMPLETED,1378.96
TRANSFER,Current,2022-09-06 01:20:42,2022-09-06 01:20:43,Depositing savings,-0.60,0.00,GBP,COMPLETED,1378.36
TRANSFER,Current,2022-09-06 07:05:18,2022-09-06 07:05:19,Depositing savings,-5.00,0.00,GBP,COMPLETED,1373.36
TRANSFER,Current,2022-09-06 09:23:15,2022-09-06 09:23:15,Depositing savings,-2.10,0.00,GBP,COMPLETED,1371.26
CARD_PAYMENT,Current,2022-09-05 09:52:02,2022-09-06 09:53:16,News On The Wharf,-15.99,0.00,GBP,COMPLETED,1355.27
TRANSFER,Current,2022-09-06 10:32:10,2022-09-06 10:32:11,Depositing savings,-0.03,0.00,GBP,COMPLETED,1355.24
TRANSFER,Current,2022-09-06 11:40:31,2022-09-06 11:40:32,Depositing savings,-0.03,0.00,GBP,COMPLETED,1355.21
CARD_PAYMENT,Current,2022-09-05 18:52:10,2022-09-06 11:59:37,Ted Baker,-317.00,0.00,GBP,COMPLETED,1038.21
CARD_PAYMENT,Current,2022-09-05 08:26:15,2022-09-06 12:37:18,Starbucks,-3.35,0.00,GBP,COMPLETED,1034.86
CARD_PAYMENT,Current,2022-09-05 09:48:28,2022-09-06 12:37:18,Starbucks,-3.35,0.00,GBP,COMPLETED,1031.51
CARD_PAYMENT,Current,2022-09-05 17:47:58,2022-09-06 12:54:31,NSL,-3.91,0.00,GBP,COMPLETED,1027.60
CARD_PAYMENT,Current,2022-09-05 20:18:47,2022-09-06 12:54:32,Texaco,-51.57,0.00,GBP,COMPLETED,976.03
TRANSFER,Current,2022-09-06 13:03:30,2022-09-06 13:05:55,Depositing savings,-2.70,0.00,GBP,COMPLETED,973.33
TRANSFER,Current,2022-09-06 13:38:45,2022-09-06 13:38:46,Depositing savings,-1.80,0.00,GBP,COMPLETED,971.53
TRANSFER,Current,2022-09-06 15:12:14,2022-09-06 15:12:15,Depositing savings,-0.60,0.00,GBP,COMPLETED,970.93
TRANSFER,Current,2022-09-06 22:33:37,2022-09-06 22:33:37,Depositing savings,-3.00,0.00,GBP,COMPLETED,967.93
CARD_PAYMENT,Current,2022-09-06 01:20:42,2022-09-06 23:00:17,Transport for London,-1.80,0.00,GBP,COMPLETED,966.13
CARD_PAYMENT,Current,2022-09-05 19:36:02,2022-09-06 23:07:54,COS,-387.00,0.00,GBP,COMPLETED,579.13
TRANSFER,Current,2022-09-07 01:24:13,2022-09-07 01:24:13,Depositing savings,-0.90,0.00,GBP,COMPLETED,578.23
TRANSFER,Current,2022-09-07 07:05:34,2022-09-07 07:05:34,Depositing savings,-5.00,0.00,GBP,COMPLETED,573.23
TRANSFER,Current,2022-09-07 08:34:28,2022-09-07 08:34:28,Depositing savings,-1.95,0.00,GBP,COMPLETED,571.28
TRANSFER,Current,2022-09-07 08:50:33,2022-09-07 08:50:34,Depositing savings,-1.20,0.00,GBP,COMPLETED,570.08
CARD_PAYMENT,Current,2022-09-05 15:52:41,2022-09-07 09:09:35,Pret,-3.60,0.00,GBP,COMPLETED,566.48
CARD_PAYMENT,Current,2022-09-05 13:09:33,2022-09-07 09:09:35,Pret,-2.30,0.00,GBP,COMPLETED,564.18
CARD_PAYMENT,Current,2022-09-06 10:32:08,2022-09-07 09:32:40,News On The Wharf,-15.99,0.00,GBP,COMPLETED,548.19
TRANSFER,Current,2022-09-07 10:04:32,2022-09-07 10:04:32,Depositing savings,-1.95,0.00,GBP,COMPLETED,546.24
CARD_PAYMENT,Current,2022-09-07 01:24:13,2022-09-07 10:54:37,Transport for London,-7.70,0.00,GBP,COMPLETED,538.54
TOPUP,Current,2022-09-07 11:39:42,2022-09-07 11:39:42,Payment from Payprop Client Acc,800.00,0.00,GBP,COMPLETED,1338.54
TRANSFER,Current,2022-09-07 12:20:51,2022-09-07 12:20:51,Depositing savings,-1.05,0.00,GBP,COMPLETED,1337.49
CARD_PAYMENT,Current,2022-09-06 22:33:36,2022-09-07 12:39:01,EE,-25.00,0.00,GBP,COMPLETED,1312.49
CARD_PAYMENT,Current,2022-09-06 09:23:14,2022-09-07 12:40:12,Starbucks,-3.30,0.00,GBP,COMPLETED,1309.19
CARD_PAYMENT,Current,2022-09-06 13:38:25,2022-09-07 13:31:48,Canary Wharf,-9.40,0.00,GBP,COMPLETED,1299.79
TRANSFER,Current,2022-09-07 14:23:38,2022-09-07 14:23:38,Depositing savings,-1.50,0.00,GBP,COMPLETED,1298.29
CARD_REFUND,Current,2022-09-07 01:00:00,2022-09-07 15:01:51,COS,53.10,0.00,GBP,COMPLETED,1351.39
CARD_PAYMENT,Current,2022-09-06 13:03:30,2022-09-07 15:02:00,COS,-53.10,0.00,GBP,COMPLETED,1298.29
TRANSFER,Current,2022-09-07 15:22:50,2022-09-07 15:22:50,Depositing savings,-0.03,0.00,GBP,COMPLETED,1298.26
TRANSFER,Current,2022-09-07 15:40:45,2022-09-07 15:40:46,Depositing savings,-1.20,0.00,GBP,COMPLETED,1297.06
CARD_PAYMENT,Current,2022-09-06 11:39:23,2022-09-07 17:54:15,Apple,-14.99,0.00,GBP,COMPLETED,1282.07
TRANSFER,Current,2022-09-07 20:17:12,2022-09-07 20:17:25,Depositing savings,-3.00,0.00,GBP,COMPLETED,1279.07
TRANSFER,Current,2022-09-07 20:33:48,2022-09-07 20:33:49,Depositing savings,-3.00,0.00,GBP,COMPLETED,1276.07
TRANSFER,Current,2022-09-08 01:23:10,2022-09-08 01:23:10,Depositing savings,-3.00,0.00,GBP,COMPLETED,1273.07
TRANSFER,Current,2022-09-08 07:06:47,2022-09-08 07:06:48,Depositing savings,-5.00,0.00,GBP,COMPLETED,1268.07
TRANSFER,Current,2022-09-08 09:22:48,2022-09-08 09:22:49,Depositing savings,-2.10,0.00,GBP,COMPLETED,1265.97
CARD_PAYMENT,Current,2022-09-06 15:12:14,2022-09-08 09:44:39,Pret,-1.80,0.00,GBP,COMPLETED,1264.17
CARD_PAYMENT,Current,2022-09-07 15:22:50,2022-09-08 10:08:08,News On The Wharf,-15.99,0.00,GBP,COMPLETED,1248.18
TRANSFER,Current,2022-09-08 10:11:37,2022-09-08 10:11:37,Depositing savings,-2.70,0.00,GBP,COMPLETED,1245.48
TRANSFER,Current,2022-09-08 12:07:42,2022-09-08 12:07:42,Depositing savings,-3.00,0.00,GBP,COMPLETED,1242.48
CARD_PAYMENT,Current,2022-09-07 10:04:31,2022-09-08 12:38:08,Starbucks,-3.35,0.00,GBP,COMPLETED,1239.13
CARD_PAYMENT,Current,2022-09-07 08:34:28,2022-09-08 12:38:08,Starbucks,-3.35,0.00,GBP,COMPLETED,1235.78
CARD_PAYMENT,Current,2022-09-07 14:23:38,2022-09-08 12:38:08,Starbucks,-4.50,0.00,GBP,COMPLETED,1231.28
CARD_PAYMENT,Current,2022-09-07 15:40:45,2022-09-08 14:01:39,Canary Wharf,-11.60,0.00,GBP,COMPLETED,1219.68
CARD_PAYMENT,Current,2022-09-07 12:20:46,2022-09-08 15:06:44,Tank & Paddle,-5.65,0.00,GBP,COMPLETED,1214.03
TRANSFER,Current,2022-09-08 15:41:20,2022-09-08 15:41:33,Depositing savings,-0.45,0.00,GBP,COMPLETED,1213.58
TRANSFER,Current,2022-09-08 15:42:31,2022-09-08 15:42:44,Depositing savings,-0.03,0.00,GBP,COMPLETED,1213.55
CARD_PAYMENT,Current,2022-09-08 01:23:09,2022-09-08 18:06:59,Transport for London,-7.00,0.00,GBP,COMPLETED,1206.55
TRANSFER,Current,2022-09-08 19:46:46,2022-09-08 19:46:50,Depositing savings,-1.20,0.00,GBP,COMPLETED,1205.35
TRANSFER,Current,2022-09-09 01:24:06,2022-09-09 01:24:16,Depositing savings,-0.60,0.00,GBP,COMPLETED,1204.75
TRANSFER,Current,2022-09-09 07:08:53,2022-09-09 07:08:54,Depositing savings,-5.00,0.00,GBP,COMPLETED,1199.75
CARD_PAYMENT,Current,2022-09-08 15:42:31,2022-09-09 09:35:42,News On The Wharf,-15.99,0.00,GBP,COMPLETED,1183.76
CARD_PAYMENT,Current,2022-09-07 08:50:33,2022-09-09 09:38:35,Pret,-1.60,0.00,GBP,COMPLETED,1182.16
TRANSFER,Current,2022-09-09 09:46:51,2022-09-09 09:46:51,Depositing savings,-1.95,0.00,GBP,COMPLETED,1180.21
TRANSFER,Current,2022-09-09 10:56:52,2022-09-09 10:57:02,Depositing savings,-2.70,0.00,GBP,COMPLETED,1177.51
CARD_PAYMENT,Current,2022-09-08 12:07:42,2022-09-09 11:35:30,Level39,-5.00,0.00,GBP,COMPLETED,1172.51
CARD_PAYMENT,Current,2022-09-07 20:33:48,2022-09-09 12:11:39,No 35 Mackenzie Walk,-7.00,0.00,GBP,COMPLETED,1165.51
CARD_PAYMENT,Current,2022-09-07 20:17:11,2022-09-09 12:11:39,No 35 Mackenzie Walk,-7.00,0.00,GBP,COMPLETED,1158.51
TRANSFER,Current,2022-09-09 12:13:57,2022-09-09 12:14:14,Withdrawing savings,1000.00,0.00,GBP,COMPLETED,2158.51
EXCHANGE,Current,2022-09-09 12:14:46,2022-09-09 12:14:46,Exchanged to EUR,-1000.00,0.00,GBP,COMPLETED,1158.51
TRANSFER,Current,2022-09-09 12:29:16,2022-09-09 12:29:25,Depositing savings,-3.00,0.00,GBP,COMPLETED,1155.51
CARD_PAYMENT,Current,2022-09-08 10:11:37,2022-09-09 12:41:02,Starbucks,-3.10,0.00,GBP,COMPLETED,1152.41
CARD_PAYMENT,Current,2022-09-08 09:22:48,2022-09-09 12:41:02,Starbucks,-3.30,0.00,GBP,COMPLETED,1149.11
TRANSFER,Current,2022-09-09 12:42:08,2022-09-09 12:42:13,Depositing savings,-0.06,0.00,GBP,COMPLETED,1149.05
CARD_PAYMENT,Current,2022-09-08 15:41:20,2022-09-09 13:18:34,Pret,-2.85,0.00,GBP,COMPLETED,1146.20
CARD_PAYMENT,Current,2022-09-09 01:24:06,2022-09-09 15:24:23,Transport for London,-1.80,0.00,GBP,COMPLETED,1144.40
TRANSFER,Current,2022-09-09 19:07:20,2022-09-09 19:07:31,Depositing savings,-3.00,0.00,GBP,COMPLETED,1141.40
TOPUP,Current,2022-09-09 22:40:57,2022-09-09 22:40:57,Payment from Balabanov M,1000.00,0.00,GBP,COMPLETED,2141.40
TRANSFER,Current,2022-09-10 01:22:50,2022-09-10 01:22:50,Depositing savings,-1.80,0.00,GBP,COMPLETED,2139.60
TRANSFER,Current,2022-09-10 07:06:37,2022-09-10 07:06:37,Depositing savings,-5.00,0.00,GBP,COMPLETED,2134.60
CARD_PAYMENT,Current,2022-09-08 19:46:46,2022-09-10 10:05:53,Riverside Supermarket,-29.60,0.00,GBP,COMPLETED,2105.00
CARD_PAYMENT,Current,2022-09-09 12:42:08,2022-09-10 10:50:20,News On The Wharf,-16.98,0.00,GBP,COMPLETED,2088.02
CARD_PAYMENT,Current,2022-09-09 19:07:16,2022-09-10 11:22:35,The Royal Society,-59.00,0.00,GBP,COMPLETED,2029.02
CARD_PAYMENT,Current,2022-09-09 12:29:10,2022-09-10 12:37:08,Allworks Properties,-100.00,0.00,GBP,COMPLETED,1929.02
TRANSFER,Current,2022-09-10 12:59:13,2022-09-10 12:59:13,Depositing savings,-1.50,0.00,GBP,COMPLETED,1927.52
CARD_PAYMENT,Current,2022-09-09 10:56:52,2022-09-10 13:03:34,Starbucks,-3.10,0.00,GBP,COMPLETED,1924.42
CARD_PAYMENT,Current,2022-09-09 09:46:50,2022-09-10 13:03:34,Starbucks,-3.35,0.00,GBP,COMPLETED,1921.07
TRANSFER,Current,2022-09-10 15:03:13,2022-09-10 15:03:13,Depositing savings,-3.00,0.00,GBP,COMPLETED,1918.07
TRANSFER,Current,2022-09-10 15:08:40,2022-09-10 15:08:48,Depositing savings,-2.25,0.00,GBP,COMPLETED,1915.82
CARD_PAYMENT,Current,2022-09-10 01:22:50,2022-09-11 01:28:11,Transport for London,-3.40,0.00,GBP,COMPLETED,1912.42
TRANSFER,Current,2022-09-11 07:05:42,2022-09-11 07:05:43,Depositing savings,-5.00,0.00,GBP,COMPLETED,1907.42
TRANSFER,Current,2022-09-11 10:03:03,2022-09-11 10:03:04,Depositing savings,-2.25,0.00,GBP,COMPLETED,1905.17
CARD_PAYMENT,Current,2022-09-10 15:03:13,2022-09-11 11:39:14,SPIRITS OF EAST,-31.00,0.00,GBP,COMPLETED,1874.17
TRANSFER,Current,2022-09-11 11:51:04,2022-09-11 11:51:05,Depositing savings,-2.10,0.00,GBP,COMPLETED,1872.07
TRANSFER,Current,2022-09-11 12:08:51,2022-09-11 12:08:54,Depositing savings,-0.03,0.00,GBP,COMPLETED,1872.04
TRANSFER,Current,2022-09-11 12:29:16,2022-09-11 12:29:20,Depositing savings,-0.60,0.00,GBP,COMPLETED,1871.44
CARD_PAYMENT,Current,2022-09-10 12:59:04,2022-09-11 12:53:49,GAIL's Bakery,-36.50,0.00,GBP,COMPLETED,1834.94
CARD_PAYMENT,Current,2022-09-10 15:08:40,2022-09-11 23:58:17,Sainsbury's,-7.25,0.00,GBP,COMPLETED,1827.69
TRANSFER,Current,2022-09-12 01:00:00,2022-09-12 01:11:12,To Billing Better,-182.82,0.00,GBP,COMPLETED,1644.87
TRANSFER,Current,2022-09-12 07:11:39,2022-09-12 07:11:39,Depositing savings,-3.00,0.00,GBP,COMPLETED,1641.87
TRANSFER,Current,2022-09-12 07:28:19,2022-09-12 07:28:22,Depositing savings,-5.00,0.00,GBP,COMPLETED,1636.87
TRANSFER,Current,2022-09-12 09:04:36,2022-09-12 09:04:37,Depositing savings,-0.06,0.00,GBP,COMPLETED,1636.81
TRANSFER,Current,2022-09-12 10:13:41,2022-09-12 10:13:42,Depositing savings,-1.95,0.00,GBP,COMPLETED,1634.86
CARD_PAYMENT,Current,2022-09-11 11:51:04,2022-09-12 12:34:49,Starbucks,-3.30,0.00,GBP,COMPLETED,1631.56
TRANSFER,Current,2022-09-12 12:55:30,2022-09-12 12:55:38,Depositing savings,-0.60,0.00,GBP,COMPLETED,1630.96
CARD_PAYMENT,Current,2022-09-11 12:29:16,2022-09-12 13:28:14,Canary Wharf,-4.80,0.00,GBP,COMPLETED,1626.16
TRANSFER,Current,2022-09-12 14:21:26,2022-09-12 14:21:27,Depositing savings,-2.40,0.00,GBP,COMPLETED,1623.76
CARD_PAYMENT,Current,2022-09-11 10:03:03,2022-09-12 14:31:40,Sainsbury's,-10.25,0.00,GBP,COMPLETED,1613.51
CARD_PAYMENT,Current,2022-09-11 12:08:51,2022-09-12 15:09:01,Apple,-4.99,0.00,GBP,COMPLETED,1608.52
TRANSFER,Current,2022-09-12 18:54:09,2022-09-12 18:54:10,Depositing savings,-2.25,0.00,GBP,COMPLETED,1606.27
TRANSFER,Current,2022-09-12 19:18:37,2022-09-12 19:18:37,Depositing savings,-0.78,0.00,GBP,COMPLETED,1605.49
TRANSFER,Current,2022-09-12 19:23:03,2022-09-12 19:23:03,Depositing savings,-3.00,0.00,GBP,COMPLETED,1602.49
TRANSFER,Current,2022-09-13 01:19:27,2022-09-13 01:19:27,Depositing savings,-0.60,0.00,GBP,COMPLETED,1601.89
TRANSFER,Current,2022-09-13 07:05:07,2022-09-13 07:05:07,Depositing savings,-5.00,0.00,GBP,COMPLETED,1596.89
TRANSFER,Current,2022-09-13 08:22:41,2022-09-13 08:22:42,Depositing savings,-1.95,0.00,GBP,COMPLETED,1594.94
TRANSFER,Current,2022-09-13 08:26:03,2022-09-13 08:26:03,Depositing savings,-0.03,0.00,GBP,COMPLETED,1594.91
CARD_PAYMENT,Current,2022-09-12 14:21:26,2022-09-13 09:21:35,Notes,-3.20,0.00,GBP,COMPLETED,1591.71
CARD_PAYMENT,Current,2022-09-12 19:18:36,2022-09-13 09:29:52,News On The Wharf,-1.74,0.00,GBP,COMPLETED,1589.97
TRANSFER,Current,2022-09-13 09:39:27,2022-09-13 09:39:28,Depositing savings,-1.95,0.00,GBP,COMPLETED,1588.02
CARD_PAYMENT,Current,2022-09-12 09:04:35,2022-09-13 09:56:49,News On The Wharf,-16.98,0.00,GBP,COMPLETED,1571.04
CARD_PAYMENT,Current,2022-09-12 07:11:38,2022-09-13 10:42:58,Ripple +,-121.00,0.00,GBP,COMPLETED,1450.04
CARD_PAYMENT,Current,2022-09-12 19:23:03,2022-09-13 10:52:22,Boots,-13.00,0.00,GBP,COMPLETED,1437.04
CARD_PAYMENT,Current,2022-09-12 18:54:09,2022-09-13 11:09:08,JustGiving,-56.25,0.00,GBP,COMPLETED,1380.79
CARD_PAYMENT,Current,2022-09-12 10:13:41,2022-09-13 12:03:30,Starbucks,-3.35,0.00,GBP,COMPLETED,1377.44
TRANSFER,Current,2022-09-13 12:22:20,2022-09-13 12:22:23,Depositing savings,-3.00,0.00,GBP,COMPLETED,1374.44
CARD_PAYMENT,Current,2022-09-13 01:19:27,2022-09-13 13:06:46,Transport for London,-1.80,0.00,GBP,COMPLETED,1372.64
TRANSFER,Current,2022-09-13 18:26:15,2022-09-13 18:26:16,Depositing savings,-1.05,0.00,GBP,COMPLETED,1371.59
TRANSFER,Current,2022-09-13 18:29:48,2022-09-13 18:29:48,Depositing savings,-0.06,0.00,GBP,COMPLETED,1371.53
TRANSFER,Current,2022-09-14 01:23:39,2022-09-14 01:23:40,Depositing savings,-1.20,0.00,GBP,COMPLETED,1370.33
TRANSFER,Current,2022-09-14 07:05:22,2022-09-14 07:05:22,Depositing savings,-5.00,0.00,GBP,COMPLETED,1365.33
TRANSFER,Current,2022-09-14 09:22:06,2022-09-14 09:22:06,Depositing savings,-2.10,0.00,GBP,COMPLETED,1363.23
TRANSFER,Current,2022-09-14 09:25:40,2022-09-14 09:25:43,Depositing savings,-0.06,0.00,GBP,COMPLETED,1363.17
CARD_PAYMENT,Current,2022-09-13 08:26:03,2022-09-14 09:47:32,News On The Wharf,-15.99,0.00,GBP,COMPLETED,1347.18
CARD_PAYMENT,Current,2022-09-12 12:55:30,2022-09-14 09:48:02,Pret,-1.80,0.00,GBP,COMPLETED,1345.38
CARD_PAYMENT,Current,2022-09-14 01:23:39,2022-09-14 10:04:27,Transport for London,-3.60,0.00,GBP,COMPLETED,1341.78
CARD_PAYMENT,Current,2022-09-13 18:29:47,2022-09-14 10:52:45,News On The Wharf,-31.98,0.00,GBP,COMPLETED,1309.80
TRANSFER,Current,2022-09-14 11:25:48,2022-09-14 11:25:49,Depositing savings,-2.10,0.00,GBP,COMPLETED,1307.70
TRANSFER,Current,2022-09-14 13:35:08,2022-09-14 13:35:12,Depositing savings,-2.40,0.00,GBP,COMPLETED,1305.30
CARD_PAYMENT,Current,2022-09-13 08:22:41,2022-09-14 16:00:54,Starbucks,-3.35,0.00,GBP,COMPLETED,1301.95
CARD_PAYMENT,Current,2022-09-13 09:39:27,2022-09-14 16:00:54,Starbucks,-3.35,0.00,GBP,COMPLETED,1298.60
CARD_PAYMENT,Current,2022-09-13 18:26:15,2022-09-14 16:17:25,Waitrose & Partners,-23.65,0.00,GBP,COMPLETED,1274.95
TRANSFER,Current,2022-09-15 01:23:53,2022-09-15 01:23:53,Depositing savings,-1.20,0.00,GBP,COMPLETED,1273.75
TRANSFER,Current,2022-09-15 07:07:26,2022-09-15 07:07:27,Depositing savings,-5.00,0.00,GBP,COMPLETED,1268.75
TRANSFER,Current,2022-09-15 09:14:03,2022-09-15 09:14:03,Depositing savings,-1.65,0.00,GBP,COMPLETED,1267.10
TRANSFER,Current,2022-09-15 09:34:03,2022-09-15 09:34:04,Depositing savings,-2.76,0.00,GBP,COMPLETED,1264.34
TRANSFER,Current,2022-09-15 10:07:16,2022-09-15 10:07:16,Depositing savings,-0.03,0.00,GBP,COMPLETED,1264.31
CARD_PAYMENT,Current,2022-09-14 09:25:40,2022-09-15 10:25:35,News On The Wharf,-16.98,0.00,GBP,COMPLETED,1247.33
CARD_PAYMENT,Current,2022-09-14 13:35:05,2022-09-15 10:50:03,Notes,-3.20,0.00,GBP,COMPLETED,1244.13
CARD_PAYMENT,Current,2022-09-14 09:22:06,2022-09-15 13:04:22,Starbucks,-3.30,0.00,GBP,COMPLETED,1240.83
CARD_PAYMENT,Current,2022-09-14 11:25:48,2022-09-15 13:04:22,Starbucks,-3.30,0.00,GBP,COMPLETED,1237.53
CARD_PAYMENT,Current,2022-09-15 01:23:53,2022-09-15 15:18:59,Transport for London,-1.60,0.00,GBP,COMPLETED,1235.93
TRANSFER,Current,2022-09-15 23:43:53,2022-09-15 23:43:53,Depositing savings,-1.80,0.00,GBP,COMPLETED,1234.13
TRANSFER,Current,2022-09-16 01:25:01,2022-09-16 01:25:01,Depositing savings,-3.00,0.00,GBP,COMPLETED,1231.13
TRANSFER,Current,2022-09-16 07:09:07,2022-09-16 07:09:19,Depositing savings,-5.00,0.00,GBP,COMPLETED,1226.13
CARD_PAYMENT,Current,2022-09-16 01:25:01,2022-09-16 12:38:22,Transport for London,-2.00,0.00,GBP,COMPLETED,1224.13
CARD_PAYMENT,Current,2022-09-15 23:43:53,2022-09-16 12:56:45,Govia Thameslink Railway,-2.40,0.00,GBP,COMPLETED,1221.73
CARD_PAYMENT,Current,2022-09-15 09:14:03,2022-09-16 13:28:50,Pret,-3.45,0.00,GBP,COMPLETED,1218.28
CARD_PAYMENT,Current,2022-09-15 09:34:03,2022-09-16 15:39:01,WHSmith,-25.08,0.00,GBP,COMPLETED,1193.20
CARD_PAYMENT,Current,2022-09-15 10:07:15,2022-09-16 15:39:01,WHSmith,-1.99,0.00,GBP,COMPLETED,1191.21
TRANSFER,Current,2022-09-16 16:37:51,2022-09-16 16:37:55,Depositing savings,-0.81,0.00,GBP,COMPLETED,1190.40
TRANSFER,Current,2022-09-16 17:06:18,2022-09-16 17:06:34,Depositing savings,-0.39,0.00,GBP,COMPLETED,1190.01
TRANSFER,Current,2022-09-16 20:44:12,2022-09-16 20:44:12,Depositing savings,-0.21,0.00,GBP,COMPLETED,1189.80
TRANSFER,Current,2022-09-16 20:48:13,2022-09-16 20:48:13,Depositing savings,-1.50,0.00,GBP,COMPLETED,1188.30
TRANSFER,Current,2022-09-16 20:53:35,2022-09-16 20:53:35,Depositing savings,-0.60,0.00,GBP,COMPLETED,1187.70
TRANSFER,Current,2022-09-16 21:31:27,2022-09-16 21:31:27,Depositing savings,-1.50,0.00,GBP,COMPLETED,1186.20
TRANSFER,Current,2022-09-16 22:58:38,2022-09-16 22:58:38,Depositing savings,-3.00,0.00,GBP,COMPLETED,1183.20
TRANSFER,Current,2022-09-17 07:05:41,2022-09-17 07:05:42,Depositing savings,-5.00,0.00,GBP,COMPLETED,1178.20
CARD_PAYMENT,Current,2022-09-16 22:58:37,2022-09-17 11:59:58,EE,-27.00,0.00,GBP,COMPLETED,1151.20
CARD_PAYMENT,Current,2022-09-16 20:44:12,2022-09-17 12:07:10,Nisa,-29.93,0.00,GBP,COMPLETED,1121.27
TRANSFER,Current,2022-09-17 13:29:44,2022-09-17 13:29:45,Depositing savings,-2.40,0.00,GBP,COMPLETED,1118.87
CARD_PAYMENT,Current,2022-09-16 16:37:46,2022-09-17 14:06:13,McDonald's,-16.73,0.00,GBP,COMPLETED,1102.14
CARD_PAYMENT,Current,2022-09-16 21:31:27,2022-09-17 14:22:36,The Royal Oak,-2.50,0.00,GBP,COMPLETED,1099.64
CARD_PAYMENT,Current,2022-09-16 20:48:12,2022-09-17 14:22:36,The Royal Oak,-3.50,0.00,GBP,COMPLETED,1096.14
CARD_PAYMENT,Current,2022-09-16 20:53:34,2022-09-17 14:23:54,The Royal Oak,-3.80,0.00,GBP,COMPLETED,1092.34
TRANSFER,Current,2022-09-17 17:12:59,2022-09-17 17:12:59,Depositing savings,-0.75,0.00,GBP,COMPLETED,1091.59
TRANSFER,Current,2022-09-17 17:17:15,2022-09-17 17:17:15,Depositing savings,-2.40,0.00,GBP,COMPLETED,1089.19
TRANSFER,Current,2022-09-17 19:05:16,2022-09-17 19:05:16,Depositing savings,-3.00,0.00,GBP,COMPLETED,1086.19
TRANSFER,Current,2022-09-17 20:27:54,2022-09-17 20:27:55,Depositing savings,-0.03,0.00,GBP,COMPLETED,1086.16
TRANSFER,Current,2022-09-17 20:45:16,2022-09-17 20:45:16,Depositing savings,-0.90,0.00,GBP,COMPLETED,1085.26
TRANSFER,Current,2022-09-17 21:17:19,2022-09-17 21:17:19,Depositing savings,-0.45,0.00,GBP,COMPLETED,1084.81
TRANSFER,Current,2022-09-17 22:44:35,2022-09-17 22:44:35,Depositing savings,-1.95,0.00,GBP,COMPLETED,1082.86
TRANSFER,Current,2022-09-18 07:05:34,2022-09-18 07:05:35,Depositing savings,-5.00,0.00,GBP,COMPLETED,1077.86
TRANSFER,Current,2022-09-18 10:24:20,2022-09-18 10:24:21,Depositing savings,-1.35,0.00,GBP,COMPLETED,1076.51
CARD_PAYMENT,Current,2022-09-17 13:29:43,2022-09-18 12:42:15,Penypass Cafe Llanberis,-9.20,0.00,GBP,COMPLETED,1067.31
CARD_PAYMENT,Current,2022-09-17 17:12:58,2022-09-18 14:17:31,Shell,-52.75,0.00,GBP,COMPLETED,1014.56
CARD_PAYMENT,Current,2022-09-17 17:17:14,2022-09-18 16:23:43,Starbucks,-16.20,0.00,GBP,COMPLETED,998.36
CARD_PAYMENT,Current,2022-09-17 20:27:54,2022-09-18 16:33:17,Tg Pwllmeyric,-14.99,0.00,GBP,COMPLETED,983.37
TRANSFER,Current,2022-09-18 16:54:50,2022-09-18 16:54:50,Depositing savings,-1.47,0.00,GBP,COMPLETED,981.90
TRANSFER,Current,2022-09-18 16:59:05,2022-09-18 16:59:05,Depositing savings,-0.60,0.00,GBP,COMPLETED,981.30
TRANSFER,Current,2022-09-18 19:50:54,2022-09-18 19:50:55,Depositing savings,-2.55,0.00,GBP,COMPLETED,978.75
TRANSFER,Current,2022-09-19 07:28:22,2022-09-19 07:28:22,Depositing savings,-5.00,0.00,GBP,COMPLETED,973.75
TRANSFER,Current,2022-09-19 08:33:34,2022-09-19 08:33:34,Depositing savings,-2.10,0.00,GBP,COMPLETED,971.65
TRANSFER,Current,2022-09-19 08:52:35,2022-09-19 08:52:36,Depositing savings,-2.10,0.00,GBP,COMPLETED,969.55
CARD_PAYMENT,Current,2022-09-17 19:05:15,2022-09-19 09:29:12,Marriott Hotel,-199.00,0.00,GBP,COMPLETED,770.55
CARD_PAYMENT,Current,2022-09-17 22:44:35,2022-09-19 09:29:12,Marriott Hotel,-86.35,0.00,GBP,COMPLETED,684.20
CARD_PAYMENT,Current,2022-09-17 21:17:19,2022-09-19 09:29:12,Marriott Hotel,-5.85,0.00,GBP,COMPLETED,678.35
CARD_PAYMENT,Current,2022-09-17 20:45:16,2022-09-19 09:29:12,Marriott Hotel,-11.70,0.00,GBP,COMPLETED,666.65
TRANSFER,Current,2022-09-19 09:52:37,2022-09-19 09:52:37,Depositing savings,-2.10,0.00,GBP,COMPLETED,664.55
CARD_PAYMENT,Current,2022-09-18 16:54:49,2022-09-19 12:55:36,Waitrose & Partners,-62.51,0.00,GBP,COMPLETED,602.04
CARD_PAYMENT,Current,2022-09-18 16:59:04,2022-09-19 13:02:21,Canary Wharf,-4.80,0.00,GBP,COMPLETED,597.24
CARD_PAYMENT,Current,2022-09-18 10:24:20,2022-09-19 13:09:11,Leigh Delamere N/e Wh,-18.55,0.00,GBP,COMPLETED,578.69
TRANSFER,Current,2022-09-19 14:23:03,2022-09-19 14:23:04,Depositing savings,-2.10,0.00,GBP,COMPLETED,576.59
TRANSFER,Current,2022-09-19 14:51:16,2022-09-19 14:51:17,Depositing savings,-1.80,0.00,GBP,COMPLETED,574.79
TRANSFER,Current,2022-09-19 17:44:28,2022-09-19 17:44:29,Depositing savings,-0.69,0.00,GBP,COMPLETED,574.10
CARD_PAYMENT,Current,2022-09-18 19:50:54,2022-09-19 17:53:32,Dropbox,-105.15,1.05,GBP,COMPLETED,467.90
CARD_PAYMENT,Current,2022-09-13 12:22:16,2022-09-19 19:14:24,COS,-138.00,0.00,GBP,COMPLETED,329.90
TRANSFER,Current,2022-09-19 23:04:29,2022-09-19 23:04:29,Depositing savings,-3.00,0.00,GBP,COMPLETED,326.90
TRANSFER,Current,2022-09-20 07:05:25,2022-09-20 07:05:26,Depositing savings,-5.00,0.00,GBP,COMPLETED,321.90
TRANSFER,Current,2022-09-20 08:48:20,2022-09-20 08:48:21,Depositing savings,-1.95,0.00,GBP,COMPLETED,319.95
CARD_PAYMENT,Current,2022-09-19 08:33:33,2022-09-20 09:46:56,Riverside Supermarket,-15.30,0.00,GBP,COMPLETED,304.65
CARD_PAYMENT,Current,2022-09-16 17:05:07,2022-09-20 10:25:05,BP,-52.87,0.00,GBP,COMPLETED,251.78
CARD_PAYMENT,Current,2022-09-19 23:04:28,2022-09-20 11:52:56,EE,-18.00,0.00,GBP,COMPLETED,233.78
TRANSFER,Current,2022-09-20 12:21:14,2022-09-20 12:21:17,Depositing savings,-0.75,0.00,GBP,COMPLETED,233.03
CARD_PAYMENT,Current,2022-09-19 09:52:36,2022-09-20 12:24:55,Starbucks,-3.30,0.00,GBP,COMPLETED,229.73
CARD_PAYMENT,Current,2022-09-19 14:23:03,2022-09-20 12:24:55,Starbucks,-3.30,0.00,GBP,COMPLETED,226.43
CARD_PAYMENT,Current,2022-09-19 08:52:35,2022-09-20 12:24:55,Starbucks,-3.30,0.00,GBP,COMPLETED,223.13
TRANSFER,Current,2022-09-20 14:09:26,2022-09-20 14:09:28,Withdrawing savings,3000.00,0.00,GBP,COMPLETED,3223.13
TRANSFER,Current,2022-09-20 14:09:41,2022-09-20 14:09:41,Withdrawing savings,669.63,0.00,GBP,COMPLETED,3892.76
TRANSFER,Current,2022-09-20 14:14:09,2022-09-20 14:14:10,Depositing savings,-2.10,0.00,GBP,COMPLETED,3890.66
TRANSFER,Current,2022-09-20 14:16:10,2022-09-20 14:16:11,Depositing savings,-0.03,0.00,GBP,COMPLETED,3890.63
CARD_PAYMENT,Current,2022-09-20 16:08:46,,Transport for London,-80.00,0.00,GBP,REVERTED,
TRANSFER,Current,2022-09-20 16:08:46,2022-09-20 16:08:46,Depositing savings,-3.00,0.00,GBP,COMPLETED,3887.63
TRANSFER,Current,2022-09-20 16:56:45,2022-09-20 16:56:46,Depositing savings,-1.80,0.00,GBP,COMPLETED,3885.83
CARD_PAYMENT,Current,2022-09-19 17:44:28,2022-09-20 19:47:42,Apple,-86.77,0.00,GBP,COMPLETED,3799.06
TRANSFER,Current,2022-09-20 21:19:39,2022-09-20 21:19:40,Depositing savings,-3.00,0.00,GBP,COMPLETED,3796.06
TRANSFER,Current,2022-09-21 01:24:40,2022-09-21 01:25:30,Depositing savings,-0.90,0.00,GBP,COMPLETED,3795.16
TRANSFER,Current,2022-09-21 07:05:22,2022-09-21 07:05:22,Depositing savings,-5.00,0.00,GBP,COMPLETED,3790.16
CARD_PAYMENT,Current,2022-09-21 01:24:40,2022-09-21 10:52:15,Transport for London,-7.70,0.00,GBP,COMPLETED,3782.46
CARD_PAYMENT,Current,2022-09-19 14:51:16,2022-09-21 11:35:42,Pret,-11.40,0.00,GBP,COMPLETED,3771.06
TRANSFER,Current,2022-09-21 11:42:41,2022-09-21 11:42:42,Depositing savings,-1.95,0.00,GBP,COMPLETED,3769.11
CARD_PAYMENT,Current,2022-09-20 14:16:10,2022-09-21 12:00:40,News On The Wharf,-15.99,0.00,GBP,COMPLETED,3753.12
TRANSFER,Current,2022-09-21 12:33:42,2022-09-21 12:33:46,Depositing savings,-2.10,0.00,GBP,COMPLETED,3751.02
CARD_PAYMENT,Current,2022-09-20 08:48:20,2022-09-21 14:07:33,Starbucks,-3.35,0.00,GBP,COMPLETED,3747.67
CARD_PAYMENT,Current,2022-09-20 14:14:09,2022-09-21 14:07:33,Starbucks,-3.30,0.00,GBP,COMPLETED,3744.37
TRANSFER,Current,2022-09-21 14:23:52,2022-09-21 14:23:53,Depositing savings,-2.10,0.00,GBP,COMPLETED,3742.27
CARD_PAYMENT,Current,2022-09-20 16:56:45,2022-09-21 14:56:08,The Grandstand Bar,-6.40,0.00,GBP,COMPLETED,3735.87
TRANSFER,Current,2022-09-21 18:25:30,2022-09-21 18:25:31,Depositing savings,-2.25,0.00,GBP,COMPLETED,3733.62
TRANSFER,Current,2022-09-21 18:31:23,2022-09-21 18:31:26,Depositing savings,-1.50,0.00,GBP,COMPLETED,3732.12
TRANSFER,Current,2022-09-22 01:24:39,2022-09-22 01:24:43,Depositing savings,-1.80,0.00,GBP,COMPLETED,3730.32
TRANSFER,Current,2022-09-22 03:17:37,2022-09-22 03:17:37,Depositing savings,-0.03,0.00,GBP,COMPLETED,3730.29
TRANSFER,Current,2022-09-22 07:06:33,2022-09-22 07:06:34,Depositing savings,-5.00,0.00,GBP,COMPLETED,3725.29
TRANSFER,Current,2022-09-22 10:27:14,2022-09-22 10:27:14,Depositing savings,-2.10,0.00,GBP,COMPLETED,3723.19
CARD_PAYMENT,Current,2022-09-20 12:21:13,2022-09-22 10:30:40,BP,-48.75,0.00,GBP,COMPLETED,3674.44
TRANSFER,Current,2022-09-22 10:30:41,2022-09-22 10:30:41,Depositing savings,-0.03,0.00,GBP,COMPLETED,3674.41
CARD_PAYMENT,Current,2022-09-21 18:31:23,2022-09-22 11:48:13,Boots,-34.50,0.00,GBP,COMPLETED,3639.91
CARD_PAYMENT,Current,2022-09-20 21:19:39,2022-09-22 12:20:49,No 35 Mackenzie Walk,-7.00,0.00,GBP,COMPLETED,3632.91
TRANSFER,Current,2022-09-22 12:42:42,2022-09-22 12:42:42,Depositing savings,-2.10,0.00,GBP,COMPLETED,3630.81
CARD_PAYMENT,Current,2022-09-21 11:42:41,2022-09-22 13:17:27,Starbucks,-3.35,0.00,GBP,COMPLETED,3627.46
CARD_PAYMENT,Current,2022-09-21 12:33:42,2022-09-22 13:17:27,Starbucks,-3.30,0.00,GBP,COMPLETED,3624.16
CARD_PAYMENT,Current,2022-09-21 14:23:52,2022-09-22 13:17:27,Starbucks,-3.30,0.00,GBP,COMPLETED,3620.86
CARD_PAYMENT,Current,2022-09-21 18:25:30,2022-09-22 13:40:25,Waitrose & Partners,-30.25,0.00,GBP,COMPLETED,3590.61
CARD_PAYMENT,Current,2022-09-22 01:24:39,2022-09-22 15:17:20,Transport for London,-3.40,0.00,GBP,COMPLETED,3587.21
TRANSFER,Current,2022-09-22 18:45:37,2022-09-22 18:45:38,Depositing savings,-2.25,0.00,GBP,COMPLETED,3584.96
TRANSFER,Current,2022-09-23 01:25:24,2022-09-23 01:25:25,Depositing savings,-2.40,0.00,GBP,COMPLETED,3582.56
TRANSFER,Current,2022-09-23 07:08:57,2022-09-23 07:08:57,Depositing savings,-5.00,0.00,GBP,COMPLETED,3577.56
TRANSFER,Current,2022-09-23 10:35:14,2022-09-23 10:35:15,Depositing savings,-2.10,0.00,GBP,COMPLETED,3575.46
CARD_PAYMENT,Current,2022-09-22 10:30:40,2022-09-23 10:42:32,News On The Wharf,-15.99,0.00,GBP,COMPLETED,3559.47
TRANSFER,Current,2022-09-23 10:53:06,2022-09-23 10:53:06,Depositing savings,-2.31,0.00,GBP,COMPLETED,3557.16
TRANSFER,Current,2022-09-23 12:02:21,2022-09-23 12:02:33,Depositing savings,-1.95,0.00,GBP,COMPLETED,3555.21
TRANSFER,Current,2022-09-23 13:01:35,2022-09-23 13:01:50,Depositing savings,-1.35,0.00,GBP,COMPLETED,3553.86
CARD_PAYMENT,Current,2022-09-22 10:27:13,2022-09-23 13:02:21,Starbucks,-3.30,0.00,GBP,COMPLETED,3550.56
CARD_PAYMENT,Current,2022-09-22 12:42:40,2022-09-23 13:02:21,Starbucks,-3.30,0.00,GBP,COMPLETED,3547.26
CARD_PAYMENT,Current,2022-09-22 18:45:36,2022-09-23 13:31:41,Waitrose & Partners,-15.25,0.00,GBP,COMPLETED,3532.01
TRANSFER,Current,2022-09-23 14:35:35,2022-09-23 14:35:51,Depositing savings,-0.03,0.00,GBP,COMPLETED,3531.98
TRANSFER,Current,2022-09-23 14:37:52,2022-09-23 14:38:07,Depositing savings,-2.10,0.00,GBP,COMPLETED,3529.88
CARD_PAYMENT,Current,2022-09-23 01:25:24,2022-09-23 14:48:31,Transport for London,-3.20,0.00,GBP,COMPLETED,3526.68
TRANSFER,Current,2022-09-23 17:45:25,2022-09-23 17:45:30,Depositing savings,-0.24,0.00,GBP,COMPLETED,3526.44
CARD_PAYMENT,Current,2022-09-22 03:17:36,2022-09-23 20:55:28,Apple,-6.99,0.00,GBP,COMPLETED,3519.45
TRANSFER,Current,2022-09-24 01:22:39,2022-09-24 01:22:40,Depositing savings,-1.80,0.00,GBP,COMPLETED,3517.65
TRANSFER,Current,2022-09-24 07:05:40,2022-09-24 07:05:40,Depositing savings,-5.00,0.00,GBP,COMPLETED,3512.65
CARD_PAYMENT,Current,2022-09-23 14:35:02,2022-09-24 10:27:34,News On The Wharf,-15.99,0.00,GBP,COMPLETED,3496.66
CARD_PAYMENT,Current,2022-09-23 10:53:05,2022-09-24 11:42:43,Boots,-15.23,0.00,GBP,COMPLETED,3481.43
CARD_PAYMENT,Current,2022-09-23 12:02:20,2022-09-24 12:46:19,Starbucks,-3.35,0.00,GBP,COMPLETED,3478.08
CARD_PAYMENT,Current,2022-09-23 10:35:13,2022-09-24 12:46:19,Starbucks,-3.30,0.00,GBP,COMPLETED,3474.78
CARD_PAYMENT,Current,2022-09-23 17:45:25,2022-09-24 13:48:41,Waitrose & Partners,-93.92,0.00,GBP,COMPLETED,3380.86
CARD_PAYMENT,Current,2022-09-23 13:01:34,2022-09-24 14:13:23,Marugame Udon,-12.55,0.00,GBP,COMPLETED,3368.31
CARD_PAYMENT,Current,2022-09-24 01:22:39,2022-09-25 01:14:26,Transport for London,-3.40,0.00,GBP,COMPLETED,3364.91
TRANSFER,Current,2022-09-25 07:05:58,2022-09-25 07:06:01,Depositing savings,-5.00,0.00,GBP,COMPLETED,3359.91
CARD_PAYMENT,Current,2022-09-23 14:37:01,2022-09-25 09:59:23,Pret,-2.30,0.00,GBP,COMPLETED,3357.61
TRANSFER,Current,2022-09-25 14:51:38,2022-09-25 14:51:38,Depositing savings,-1.20,0.00,GBP,COMPLETED,3356.41
TRANSFER,Current,2022-09-25 15:09:07,2022-09-25 15:09:08,Depositing savings,-1.95,0.00,GBP,COMPLETED,3354.46
TRANSFER,Current,2022-09-25 16:22:11,2022-09-25 16:22:11,Depositing savings,-3.00,0.00,GBP,COMPLETED,3351.46
TRANSFER,Current,2022-09-25 16:24:25,2022-09-25 16:24:26,Depositing savings,-2.70,0.00,GBP,COMPLETED,3348.76
TRANSFER,Current,2022-09-25 20:36:19,2022-09-25 20:36:20,Depositing savings,-2.40,0.00,GBP,COMPLETED,3346.36
TRANSFER,Current,2022-09-26 01:00:00,2022-09-26 01:06:10,To Tfl Congestn Chrge,-75.00,0.00,GBP,COMPLETED,3271.36
TRANSFER,Current,2022-09-26 07:29:17,2022-09-26 07:29:18,Depositing savings,-5.00,0.00,GBP,COMPLETED,3266.36
CARD_PAYMENT,Current,2022-09-25 14:51:38,2022-09-26 09:26:29,Riverside Supermarket,-30.60,0.00,GBP,COMPLETED,3235.76
CARD_PAYMENT,Current,2022-09-25 20:36:19,2022-09-26 10:30:27,Hazev Restaurant,-18.20,0.00,GBP,COMPLETED,3217.56
CARD_PAYMENT,Current,2022-09-25 16:22:10,2022-09-26 10:32:33,Adam Grooming Atelier,-30.00,0.00,GBP,COMPLETED,3187.56
CARD_PAYMENT,Current,2022-09-25 15:09:07,2022-09-26 11:45:01,Starbucks,-3.35,0.00,GBP,COMPLETED,3184.21
CARD_PAYMENT,Current,2022-09-25 16:24:25,2022-09-26 11:45:01,Starbucks,-3.10,0.00,GBP,COMPLETED,3181.11
TRANSFER,Current,2022-09-26 15:12:49,2022-09-26 15:12:49,Depositing savings,-2.40,0.00,GBP,COMPLETED,3178.71
TRANSFER,Current,2022-09-26 15:16:13,2022-09-26 15:16:13,Depositing savings,-2.55,0.00,GBP,COMPLETED,3176.16
TRANSFER,Current,2022-09-26 16:14:33,2022-09-26 16:14:33,Depositing savings,-1.95,0.00,GBP,COMPLETED,3174.21
TRANSFER,Current,2022-09-26 19:24:11,2022-09-26 19:24:12,Depositing savings,-2.40,0.00,GBP,COMPLETED,3171.81
TRANSFER,Current,2022-09-27 01:18:50,2022-09-27 01:18:52,Depositing savings,-1.20,0.00,GBP,COMPLETED,3170.61
TRANSFER,Current,2022-09-27 07:05:29,2022-09-27 07:05:29,Depositing savings,-5.00,0.00,GBP,COMPLETED,3165.61
CARD_PAYMENT,Current,2022-09-26 15:16:12,2022-09-27 11:09:04,Boots,-6.15,0.00,GBP,COMPLETED,3159.46
TRANSFER,Current,2022-09-27 11:38:10,2022-09-27 11:38:10,Depositing savings,-1.95,0.00,GBP,COMPLETED,3157.51
CARD_PAYMENT,Current,2022-09-26 16:14:32,2022-09-27 13:02:14,Starbucks,-3.35,0.00,GBP,COMPLETED,3154.16
TRANSFER,Current,2022-09-27 13:08:17,2022-09-27 13:08:17,Depositing savings,-1.35,0.00,GBP,COMPLETED,3152.81
CARD_PAYMENT,Current,2022-09-26 15:12:48,2022-09-27 13:12:05,Waitrose & Partners,-43.20,0.00,GBP,COMPLETED,3109.61
CARD_PAYMENT,Current,2022-09-26 19:24:11,2022-09-27 13:12:58,Waitrose & Partners,-6.20,0.00,GBP,COMPLETED,3103.41
CARD_PAYMENT,Current,2022-09-27 01:18:49,2022-09-27 15:54:52,Transport for London,-1.60,0.00,GBP,COMPLETED,3101.81
TRANSFER,Current,2022-09-27 18:24:07,2022-09-27 18:24:07,Depositing savings,-0.06,0.00,GBP,COMPLETED,3101.75
TRANSFER,Current,2022-09-27 23:15:09,2022-09-27 23:15:09,Depositing savings,-2.40,0.00,GBP,COMPLETED,3099.35
TRANSFER,Current,2022-09-28 01:22:24,2022-09-28 01:22:24,Depositing savings,-1.80,0.00,GBP,COMPLETED,3097.55
TRANSFER,Current,2022-09-28 07:05:59,2022-09-28 07:05:59,Depositing savings,-5.00,0.00,GBP,COMPLETED,3092.55
CARD_PAYMENT,Current,2022-09-27 18:24:06,2022-09-28 10:16:53,News On The Wharf,-31.98,0.00,GBP,COMPLETED,3060.57
TRANSFER,Current,2022-09-28 10:29:41,2022-09-28 10:29:42,Withdrawing savings,1000.00,0.00,GBP,COMPLETED,4060.57
TRANSFER,Current,2022-09-28 11:32:54,2022-09-28 11:32:54,Depositing savings,-1.95,0.00,GBP,COMPLETED,4058.62
CARD_PAYMENT,Current,2022-09-27 23:15:08,2022-09-28 12:19:00,Visa Application Fee,-291.20,0.00,GBP,COMPLETED,3767.42
CARD_PAYMENT,Current,2022-09-27 11:38:10,2022-09-28 12:49:14,Starbucks,-3.35,0.00,GBP,COMPLETED,3764.07
TRANSFER,Current,2022-09-28 13:09:05,2022-09-28 13:09:07,Depositing savings,-3.00,0.00,GBP,COMPLETED,3761.07
CARD_PAYMENT,Current,2022-09-27 13:08:16,2022-09-28 13:45:21,Marugame Udon,-12.55,0.00,GBP,COMPLETED,3748.52
TRANSFER,Current,2022-09-28 14:05:50,2022-09-28 14:05:51,Depositing savings,-2.25,0.00,GBP,COMPLETED,3746.27
CARD_PAYMENT,Current,2022-09-28 01:22:24,2022-09-28 14:46:38,Transport for London,-3.40,0.00,GBP,COMPLETED,3742.87
TRANSFER,Current,2022-09-28 18:07:57,2022-09-28 18:07:58,Depositing savings,-0.75,0.00,GBP,COMPLETED,3742.12
TRANSFER,Current,2022-09-29 01:23:00,2022-09-29 01:23:00,Depositing savings,-1.20,0.00,GBP,COMPLETED,3740.92
FEE,Current,2022-09-29 01:51:59,2022-09-29 01:51:59,Metal plan fee,-12.99,0.00,GBP,COMPLETED,3727.93
TRANSFER,Current,2022-09-29 07:06:49,2022-09-29 07:06:49,Depositing savings,-5.00,0.00,GBP,COMPLETED,3722.93
TRANSFER,Current,2022-09-29 09:49:54,2022-09-29 09:49:54,Depositing savings,-1.95,0.00,GBP,COMPLETED,3720.98
TRANSFER,Current,2022-09-29 10:35:46,2022-09-29 10:35:47,Withdrawing savings,5700.00,0.00,GBP,COMPLETED,9420.98
TRANSFER,Current,2022-09-29 10:36:27,2022-09-29 10:36:27,Depositing savings,-3.00,0.00,GBP,COMPLETED,9417.98
TRANSFER,Current,2022-09-29 10:40:52,2022-09-29 10:40:53,Withdrawing savings,4000.00,0.00,GBP,COMPLETED,13417.98
TRANSFER,Current,2022-09-29 10:41:34,2022-09-29 10:41:35,Depositing savings,-3.00,0.00,GBP,COMPLETED,13414.98
TRANSFER,Current,2022-09-29 10:57:42,2022-09-29 10:57:43,Depositing savings,-3.00,0.00,GBP,COMPLETED,13411.98
CARD_PAYMENT,Current,2022-09-28 14:05:50,2022-09-29 11:00:29,Post Office,-7.25,0.00,GBP,COMPLETED,13404.73
TRANSFER,Current,2022-09-29 11:15:21,2022-09-29 11:15:21,Depositing savings,-1.95,0.00,GBP,COMPLETED,13402.78
TRANSFER,Current,2022-09-29 13:01:16,2022-09-29 13:01:17,Depositing savings,-2.70,0.00,GBP,COMPLETED,13400.08
CARD_PAYMENT,Current,2022-09-28 11:32:53,2022-09-29 13:15:55,Starbucks,-3.35,0.00,GBP,COMPLETED,13396.73
TRANSFER,Current,2022-09-29 13:34:21,2022-09-29 13:34:22,Depositing savings,-0.03,0.00,GBP,COMPLETED,13396.70
CARD_PAYMENT,Current,2022-09-28 18:07:57,2022-09-29 13:49:12,Waitrose & Partners,-18.75,0.00,GBP,COMPLETED,13377.95
CARD_PAYMENT,Current,2022-09-29 01:23:00,2022-09-29 15:16:34,Transport for London,-1.60,0.00,GBP,COMPLETED,13376.35
TRANSFER,Current,2022-09-30 01:00:00,2022-09-30 01:01:46,To Virgin Active,-139.99,0.00,GBP,COMPLETED,13236.36
TRANSFER,Current,2022-09-30 01:25:56,2022-09-30 01:25:57,Depositing savings,-1.20,0.00,GBP,COMPLETED,13235.16
TRANSFER,Current,2022-09-30 03:06:22,2022-09-30 03:06:23,Depositing savings,-3.00,0.00,GBP,COMPLETED,13232.16
TRANSFER,Current,2022-09-30 06:04:29,2022-09-30 06:04:29,Depositing savings,-0.03,0.00,GBP,COMPLETED,13232.13
TRANSFER,Current,2022-09-30 07:11:05,2022-09-30 07:11:05,Depositing savings,-5.00,0.00,GBP,COMPLETED,13227.13
TRANSFER,Current,2022-09-30 09:02:28,2022-09-30 09:02:36,To Holly Michael,-2450.00,0.00,GBP,COMPLETED,10777.13
TRANSFER,Current,2022-09-30 09:25:01,2022-09-30 09:25:01,Depositing savings,-1.95,0.00,GBP,COMPLETED,10775.18
TOPUP,Current,2022-09-30 10:06:45,2022-09-30 10:06:45,Payment from Balabanov M,10000.00,0.00,GBP,COMPLETED,20775.18
TRANSFER,Current,2022-09-30 10:07:33,2022-09-30 10:07:34,Depositing savings,-5000.00,0.00,GBP,COMPLETED,15775.18
TRANSFER,Current,2022-09-30 10:07:40,2022-09-30 10:07:40,Depositing savings,-5000.00,0.00,GBP,COMPLETED,10775.18
TRANSFER,Current,2022-09-30 10:08:04,2022-09-30 10:08:04,Withdrawing savings,5000.00,0.00,GBP,COMPLETED,15775.18
EXCHANGE,Current,2022-09-30 10:27:29,2022-09-30 10:27:29,Exchanged to EUR,-880.18,0.00,GBP,COMPLETED,14895.00
CARD_PAYMENT,Current,2022-09-28 13:09:04,2022-09-30 10:28:56,Transport for London,-80.00,0.00,GBP,COMPLETED,14815.00
CARD_PAYMENT,Current,2022-09-29 13:34:21,2022-09-30 10:30:48,Amazon Prime,-8.99,0.00,GBP,COMPLETED,14806.01
CARD_PAYMENT,Current,2022-09-29 13:01:16,2022-09-30 10:38:52,Servedup 640east Caf,-6.10,0.00,GBP,COMPLETED,14799.91
TRANSFER,Current,2022-09-30 11:53:56,2022-09-30 11:53:57,Depositing savings,-1.95,0.00,GBP,COMPLETED,14797.96
CARD_PAYMENT,Current,2022-09-29 10:57:42,2022-09-30 11:59:14,Ukvcas.co,-398.00,0.00,GBP,COMPLETED,14399.96
CARD_PAYMENT,Current,2022-09-29 10:36:26,2022-09-30 11:59:33,Ihs165510535pa01 2020,-5616.00,0.00,GBP,COMPLETED,8783.96
CARD_PAYMENT,Current,2022-09-29 10:41:34,2022-09-30 12:46:44,UK Visas and Immigration,-3876.00,0.00,GBP,COMPLETED,4907.96
CARD_PAYMENT,Current,2022-09-29 09:49:54,2022-09-30 13:21:09,Starbucks,-3.35,0.00,GBP,COMPLETED,4904.61
CARD_PAYMENT,Current,2022-09-29 11:15:20,2022-09-30 13:21:09,Starbucks,-3.35,0.00,GBP,COMPLETED,4901.26
TRANSFER,Current,2022-09-30 15:20:21,2022-09-30 15:20:26,Depositing savings,-1.35,0.00,GBP,COMPLETED,4899.91
CARD_PAYMENT,Current,2022-09-30 01:25:56,2022-09-30 15:21:02,Transport for London,-1.60,0.00,GBP,COMPLETED,4898.31
TOPUP,Current,2022-09-30 16:24:28,2022-09-30 16:24:28,Payment from Loqbox Trustee,570.00,0.00,GBP,COMPLETED,5468.31
TRANSFER,Current,2022-09-30 16:59:49,2022-09-30 17:00:00,Depositing savings,-3.00,0.00,GBP,COMPLETED,5465.31
TRANSFER,Current,2022-09-30 18:37:10,2022-09-30 18:37:11,Depositing savings,-1.23,0.00,GBP,COMPLETED,5464.08
TRANSFER,Current,2022-09-30 18:54:42,2022-09-30 18:54:42,Depositing savings,-0.30,0.00,GBP,COMPLETED,5463.78
TRANSFER,Current,2022-10-01 01:21:14,2022-10-01 01:21:14,Depositing savings,-1.80,0.00,GBP,COMPLETED,5461.98
CARD_PAYMENT,Current,2022-09-30 06:04:28,2022-10-01 01:29:00,Netflix,-10.99,0.00,GBP,COMPLETED,5450.99
TRANSFER,Current,2022-10-01 07:11:38,2022-10-01 07:11:38,Depositing savings,-5.00,0.00,GBP,COMPLETED,5445.99
CARD_PAYMENT,Current,2022-09-30 18:37:08,2022-10-01 10:42:24,News On The Wharf,-34.59,0.00,GBP,COMPLETED,5411.40
CARD_PAYMENT,Current,2022-09-30 03:06:22,2022-10-01 12:31:05,Loqbox,-50.00,0.00,GBP,COMPLETED,5361.40
TRANSFER,Current,2022-10-01 13:09:51,2022-10-01 13:09:52,Depositing savings,-3.00,0.00,GBP,COMPLETED,5358.40
CARD_PAYMENT,Current,2022-09-30 11:53:56,2022-10-01 13:17:35,Starbucks,-3.35,0.00,GBP,COMPLETED,5355.05
CARD_PAYMENT,Current,2022-09-30 09:25:00,2022-10-01 13:17:35,Starbucks,-3.35,0.00,GBP,COMPLETED,5351.70
CARD_PAYMENT,Current,2022-09-30 15:20:09,2022-10-01 14:55:52,Marugame Udon,-12.55,0.00,GBP,COMPLETED,5339.15
CARD_PAYMENT,Current,2022-09-30 18:54:41,2022-10-01 15:46:55,Waitrose & Partners,-30.90,0.00,GBP,COMPLETED,5308.25
TRANSFER,Current,2022-10-01 16:30:16,2022-10-01 16:30:16,Depositing savings,-3.00,0.00,GBP,COMPLETED,5305.25
TRANSFER,Current,2022-10-01 16:38:03,2022-10-01 16:38:04,Depositing savings,-0.90,0.00,GBP,COMPLETED,5304.35
TRANSFER,Current,2022-10-01 20:01:19,2022-10-01 20:01:19,Depositing savings,-1.86,0.00,GBP,COMPLETED,5302.49
TRANSFER,Current,2022-10-02 07:06:15,2022-10-02 07:06:15,Depositing savings,-5.00,0.00,GBP,COMPLETED,5297.49
TRANSFER,Current,2022-10-02 09:01:34,2022-10-02 09:01:34,To Natalia Balabanova,-2000.00,0.00,GBP,COMPLETED,3297.49
TRANSFER,Current,2022-10-02 09:01:34,2022-10-02 09:01:35,To Aleksandra Balabanova,-600.00,0.00,GBP,COMPLETED,2697.49
CARD_PAYMENT,Current,2022-09-30 16:59:43,2022-10-02 09:27:56,COS,-19.00,0.00,GBP,COMPLETED,2678.49
CARD_PAYMENT,Current,2022-10-01 01:21:14,2022-10-02 10:28:43,Transport for London,-3.40,0.00,GBP,COMPLETED,2675.09
CARD_PAYMENT,Current,2022-10-01 13:09:51,2022-10-02 11:43:50,The Royal Society,-33.00,0.00,GBP,COMPLETED,2642.09
CARD_PAYMENT,Current,2022-10-01 20:01:18,2022-10-02 13:20:11,Sainsbury's,-21.38,0.00,GBP,COMPLETED,2620.71
CARD_PAYMENT,Current,2022-10-01 16:30:16,2022-10-02 15:39:06,National Trust,-3.00,0.00,GBP,COMPLETED,2617.71
CARD_PAYMENT,Current,2022-10-01 16:38:03,2022-10-02 15:39:06,National Trust,-9.70,0.00,GBP,COMPLETED,2608.01
TRANSFER,Current,2022-10-03 07:29:59,2022-10-03 07:29:59,Depositing savings,-5.00,0.00,GBP,COMPLETED,2603.01
TRANSFER,Current,2022-10-03 08:54:51,2022-10-03 08:54:51,Depositing savings,-1.95,0.00,GBP,COMPLETED,2601.06
TRANSFER,Current,2022-10-03 09:00:58,2022-10-03 09:00:59,Depositing savings,-0.03,0.00,GBP,COMPLETED,2601.03
TRANSFER,Current,2022-10-03 09:52:14,2022-10-03 09:52:14,Depositing savings,-1.95,0.00,GBP,COMPLETED,2599.08
TRANSFER,Current,2022-10-03 12:09:19,2022-10-03 12:09:19,Depositing savings,-1.95,0.00,GBP,COMPLETED,2597.13
TOPUP,Current,2022-10-03 14:54:32,2022-10-03 14:54:32,Payment from Balabanov M,10000.00,0.00,GBP,COMPLETED,12597.13
TRANSFER,Current,2022-10-03 14:54:59,2022-10-03 14:55:00,Depositing savings,-10000.00,0.00,GBP,COMPLETED,2597.13
TRANSFER,Current,2022-10-03 18:33:19,2022-10-03 18:33:20,Depositing savings,-2.25,0.00,GBP,COMPLETED,2594.88
TRANSFER,Current,2022-10-03 18:40:58,2022-10-03 18:40:58,Depositing savings,-2.88,0.00,GBP,COMPLETED,2592.00
TRANSFER,Current,2022-10-03 18:49:05,2022-10-03 18:49:05,Depositing savings,-2.25,0.00,GBP,COMPLETED,2589.75
TRANSFER,Current,2022-10-03 19:05:36,2022-10-03 19:05:36,Depositing savings,-0.21,0.00,GBP,COMPLETED,2589.54
TRANSFER,Current,2022-10-04 01:20:49,2022-10-04 01:20:49,Depositing savings,-1.80,0.00,GBP,COMPLETED,2587.74
TRANSFER,Current,2022-10-04 07:05:28,2022-10-04 07:05:29,Depositing savings,-5.00,0.00,GBP,COMPLETED,2582.74
CARD_PAYMENT,Current,2022-10-03 19:05:36,2022-10-04 10:24:29,Holland & Barrett,-56.93,0.00,GBP,COMPLETED,2525.81
CARD_PAYMENT,Current,2022-10-04 01:20:49,2022-10-04 10:28:53,Transport for London,-3.40,0.00,GBP,COMPLETED,2522.41
CARD_PAYMENT,Current,2022-10-03 09:00:57,2022-10-04 11:27:31,News On The Wharf,-0.99,0.00,GBP,COMPLETED,2521.42
CARD_PAYMENT,Current,2022-10-03 18:49:05,2022-10-04 12:58:05,Boots,-28.25,0.00,GBP,COMPLETED,2493.17
CARD_PAYMENT,Current,2022-10-03 18:33:18,2022-10-04 13:45:11,Waitrose & Partners,-2.25,0.00,GBP,COMPLETED,2490.92
TRANSFER,Current,2022-10-04 14:11:08,2022-10-04 14:11:08,Depositing savings,-1.80,0.00,GBP,COMPLETED,2489.12
TRANSFER,Current,2022-10-04 14:22:46,2022-10-04 14:22:47,Depositing savings,-1.95,0.00,GBP,COMPLETED,2487.17
CARD_PAYMENT,Current,2022-10-03 18:40:58,2022-10-04 15:11:12,Tian Tian Market,-22.04,0.00,GBP,COMPLETED,2465.13
TRANSFER,Current,2022-10-04 16:20:32,2022-10-04 16:20:32,Depositing savings,-2.10,0.00,GBP,COMPLETED,2463.03
TRANSFER,Current,2022-10-05 01:22:47,2022-10-05 01:22:47,Depositing savings,-1.20,0.00,GBP,COMPLETED,2461.83
TRANSFER,Current,2022-10-05 07:06:17,2022-10-05 07:06:18,Depositing savings,-5.00,0.00,GBP,COMPLETED,2456.83
CARD_PAYMENT,Current,2022-10-04 14:11:07,2022-10-05 09:39:16,Grocery Station,-14.40,0.00,GBP,COMPLETED,2442.43
CARD_PAYMENT,Current,2022-10-03 09:52:14,2022-10-05 10:24:26,Starbucks,-3.35,0.00,GBP,COMPLETED,2439.08
CARD_PAYMENT,Current,2022-10-03 08:54:50,2022-10-05 10:24:26,Starbucks,-3.35,0.00,GBP,COMPLETED,2435.73
CARD_PAYMENT,Current,2022-10-03 12:09:19,2022-10-05 10:24:26,Starbucks,-3.35,0.00,GBP,COMPLETED,2432.38
CARD_PAYMENT,Current,2022-10-04 14:22:46,2022-10-05 11:06:55,Starbucks,-3.35,0.00,GBP,COMPLETED,2429.03
CARD_PAYMENT,Current,2022-10-04 16:20:31,2022-10-05 11:06:55,Starbucks,-3.30,0.00,GBP,COMPLETED,2425.73
TRANSFER,Current,2022-10-05 11:10:15,2022-10-05 11:10:15,Depositing savings,-3.00,0.00,GBP,COMPLETED,2422.73
TRANSFER,Current,2022-10-05 12:58:45,2022-10-05 12:58:49,Depositing savings,-1.08,0.00,GBP,COMPLETED,2421.65
TRANSFER,Current,2022-10-05 12:59:31,2022-10-05 12:59:32,From Mansur Kurmakaev,15.70,0.00,GBP,COMPLETED,2437.35
CARD_PAYMENT,Current,2022-10-05 01:22:47,2022-10-05 13:59:28,Transport for London,-1.60,0.00,GBP,COMPLETED,2435.75
TRANSFER,Current,2022-10-05 19:13:03,2022-10-05 19:13:04,Depositing savings,-1.20,0.00,GBP,COMPLETED,2434.55
TRANSFER,Current,2022-10-06 01:16:07,2022-10-06 01:16:08,Depositing savings,-0.90,0.00,GBP,COMPLETED,2433.65
TRANSFER,Current,2022-10-06 07:06:51,2022-10-06 07:06:51,Depositing savings,-5.00,0.00,GBP,COMPLETED,2428.65
TRANSFER,Current,2022-10-06 09:46:16,2022-10-06 09:46:16,Depositing savings,-1.80,0.00,GBP,COMPLETED,2426.85
TRANSFER,Current,2022-10-06 09:56:30,2022-10-06 09:56:31,Depositing savings,-2.70,0.00,GBP,COMPLETED,2424.15
CARD_PAYMENT,Current,2022-10-05 11:10:15,2022-10-06 10:07:32,CreditLadder,-60.00,0.00,GBP,COMPLETED,2364.15
TRANSFER,Current,2022-10-06 11:39:10,2022-10-06 11:39:26,Depositing savings,-1.95,0.00,GBP,COMPLETED,2362.20
TRANSFER,Current,2022-10-06 11:41:54,2022-10-06 11:42:07,Depositing savings,-0.03,0.00,GBP,COMPLETED,2362.17
CARD_PAYMENT,Current,2022-10-05 19:13:03,2022-10-06 13:32:29,Sainsbury's,-32.60,0.00,GBP,COMPLETED,2329.57
CARD_PAYMENT,Current,2022-10-05 12:58:41,2022-10-06 13:53:11,Pomelo Media Marketin,-33.64,0.00,GBP,COMPLETED,2295.93
TRANSFER,Current,2022-10-06 14:20:30,2022-10-06 14:20:32,Depositing savings,-2.40,0.00,GBP,COMPLETED,2293.53
CARD_PAYMENT,Current,2022-10-06 01:16:07,2022-10-06 16:28:56,Transport for London,-7.70,0.00,GBP,COMPLETED,2285.83
TRANSFER,Current,2022-10-06 18:35:53,2022-10-06 18:35:54,Depositing savings,-2.25,0.00,GBP,COMPLETED,2283.58
TRANSFER,Current,2022-10-06 18:39:12,2022-10-06 18:39:12,Depositing savings,-0.03,0.00,GBP,COMPLETED,2283.55
TRANSFER,Current,2022-10-06 22:46:03,2022-10-06 22:46:03,Depositing savings,-3.00,0.00,GBP,COMPLETED,2280.55
TRANSFER,Current,2022-10-07 01:25:06,2022-10-07 01:25:07,Depositing savings,-1.80,0.00,GBP,COMPLETED,2278.75
TRANSFER,Current,2022-10-07 07:09:18,2022-10-07 07:09:18,Depositing savings,-5.00,0.00,GBP,COMPLETED,2273.75
CARD_PAYMENT,Current,2022-10-06 09:46:15,2022-10-07 10:26:26,Grocery Station,-14.40,0.00,GBP,COMPLETED,2259.35
TRANSFER,Current,2022-10-07 10:26:50,2022-10-07 10:26:50,Depositing savings,-1.95,0.00,GBP,COMPLETED,2257.40
CARD_PAYMENT,Current,2022-10-06 18:39:12,2022-10-07 10:35:30,News On The Wharf,-15.99,0.00,GBP,COMPLETED,2241.41
CARD_PAYMENT,Current,2022-10-06 14:20:24,2022-10-07 10:36:55,Servedup 640east Caf,-3.20,0.00,GBP,COMPLETED,2238.21
TRANSFER,Current,2022-10-07 11:52:16,2022-10-07 11:52:31,Depositing savings,-0.75,0.00,GBP,COMPLETED,2237.46
CARD_PAYMENT,Current,2022-10-06 09:56:29,2022-10-07 12:55:30,Starbucks,-5.10,0.00,GBP,COMPLETED,2232.36
CARD_PAYMENT,Current,2022-10-06 11:37:12,2022-10-07 12:55:30,Starbucks,-3.35,0.00,GBP,COMPLETED,2229.01
CARD_PAYMENT,Current,2022-10-06 18:35:53,2022-10-07 14:28:59,Waitrose & Partners,-31.25,0.00,GBP,COMPLETED,2197.76
CARD_PAYMENT,Current,2022-10-06 22:46:02,2022-10-07 14:43:40,EE,-25.00,0.00,GBP,COMPLETED,2172.76
TRANSFER,Current,2022-10-07 16:05:53,2022-10-07 16:06:06,Depositing savings,-0.48,0.00,GBP,COMPLETED,2172.28
CARD_PAYMENT,Current,2022-10-07 01:25:06,2022-10-07 16:21:09,Transport for London,-3.40,0.00,GBP,COMPLETED,2168.88
CARD_PAYMENT,Current,2022-10-06 11:39:51,2022-10-07 22:48:01,Apple,-14.99,0.00,GBP,COMPLETED,2153.89
TRANSFER,Current,2022-10-08 01:21:02,2022-10-08 01:21:02,Depositing savings,-2.40,0.00,GBP,COMPLETED,2151.49
TRANSFER,Current,2022-10-08 07:05:57,2022-10-08 07:05:58,Depositing savings,-5.00,0.00,GBP,COMPLETED,2146.49
CARD_PAYMENT,Current,2022-10-07 16:05:43,2022-10-08 10:37:28,News On The Wharf,-48.84,0.00,GBP,COMPLETED,2097.65
CARD_PAYMENT,Current,2022-10-07 10:26:39,2022-10-08 12:53:23,Starbucks,-3.35,0.00,GBP,COMPLETED,2094.30
CARD_PAYMENT,Current,2022-10-07 11:52:15,2022-10-08 12:53:23,Starbucks,-1.75,0.00,GBP,COMPLETED,2092.55
TRANSFER,Current,2022-10-08 16:53:22,2022-10-08 16:53:22,Depositing savings,-2.58,0.00,GBP,COMPLETED,2089.97
TRANSFER,Current,2022-10-08 16:56:08,2022-10-08 16:56:09,Depositing savings,-0.60,0.00,GBP,COMPLETED,2089.37
CARD_PAYMENT,Current,2022-10-08 18:54:49,,AliExpress,-0.91,0.01,GBP,REVERTED,
TRANSFER,Current,2022-10-08 18:54:50,2022-10-08 18:54:50,Depositing savings,-0.27,0.00,GBP,COMPLETED,2089.10
CARD_PAYMENT,Current,2022-10-08 01:21:02,2022-10-09 00:59:11,Transport for London,-5.20,0.00,GBP,COMPLETED,2083.90
TRANSFER,Current,2022-10-09 07:05:35,2022-10-09 07:05:36,Depositing savings,-5.00,0.00,GBP,COMPLETED,2078.90
TRANSFER,Current,2022-10-09 14:24:48,2022-10-09 14:24:48,Depositing savings,-2.10,0.00,GBP,COMPLETED,2076.80
TRANSFER,Current,2022-10-09 14:36:35,2022-10-09 14:36:35,Depositing savings,-0.75,0.00,GBP,COMPLETED,2076.05
TRANSFER,Current,2022-10-10 01:08:50,2022-10-10 01:08:50,Depositing savings,-1.20,0.00,GBP,COMPLETED,2074.85
TRANSFER,Current,2022-10-10 07:30:58,2022-10-10 07:30:59,Depositing savings,-5.00,0.00,GBP,COMPLETED,2069.85
TRANSFER,Current,2022-10-10 09:41:05,2022-10-10 09:41:06,Depositing savings,-2.70,0.00,GBP,COMPLETED,2067.15
TRANSFER,Current,2022-10-10 10:53:27,2022-10-10 10:53:27,Depositing savings,-1.95,0.00,GBP,COMPLETED,2065.20
TRANSFER,Current,2022-10-10 18:32:50,2022-10-10 18:32:50,Depositing savings,-0.06,0.00,GBP,COMPLETED,2065.14
CARD_PAYMENT,Current,2022-10-08 16:53:22,2022-10-11 01:06:47,Waitrose & Partners,-128.14,0.00,GBP,COMPLETED,1937.00
CARD_PAYMENT,Current,2022-10-08 16:56:08,2022-10-11 01:13:09,Canary Wharf,-4.80,0.00,GBP,COMPLETED,1932.20
TRANSFER,Current,2022-10-11 01:18:03,2022-10-11 01:18:03,Depositing savings,-1.80,0.00,GBP,COMPLETED,1930.40
TRANSFER,Current,2022-10-11 07:05:26,2022-10-11 07:05:26,Depositing savings,-5.00,0.00,GBP,COMPLETED,1925.40
CARD_PAYMENT,Current,2022-10-09 14:24:48,2022-10-11 08:06:20,Grocery Station,-30.30,0.00,GBP,COMPLETED,1895.10
CARD_PAYMENT,Current,2022-10-09 14:36:34,2022-10-11 08:46:24,Starbucks,-2.75,0.00,GBP,COMPLETED,1892.35
TRANSFER,Current,2022-10-11 09:28:35,2022-10-11 09:28:35,Depositing savings,-2.70,0.00,GBP,COMPLETED,1889.65
TRANSFER,Current,2022-10-11 10:11:27,2022-10-11 10:11:27,Depositing savings,-1.50,0.00,GBP,COMPLETED,1888.15
CARD_PAYMENT,Current,2022-10-10 01:08:50,2022-10-11 10:20:23,Transport for London,-1.60,0.00,GBP,COMPLETED,1886.55
TRANSFER,Current,2022-10-11 11:46:04,2022-10-11 11:46:04,Depositing savings,-1.95,0.00,GBP,COMPLETED,1884.60
TRANSFER,Current,2022-10-11 11:55:28,2022-10-11 11:55:29,Depositing savings,-0.03,0.00,GBP,COMPLETED,1884.57
TRANSFER,Current,2022-10-11 12:11:26,2022-10-11 12:11:26,Depositing savings,-0.03,0.00,GBP,COMPLETED,1884.54
TRANSFER,Current,2022-10-11 12:49:48,2022-10-11 12:49:48,Depositing savings,-3.00,0.00,GBP,COMPLETED,1881.54
TRANSFER,Current,2022-10-11 15:32:44,2022-10-11 15:32:45,Depositing savings,-2.85,0.00,GBP,COMPLETED,1878.69
TRANSFER,Current,2022-10-11 15:57:46,2022-10-11 15:57:46,Depositing savings,-2.70,0.00,GBP,COMPLETED,1875.99
CARD_PAYMENT,Current,2022-10-11 01:18:03,2022-10-11 23:16:28,Transport for London,-3.40,0.00,GBP,COMPLETED,1872.59
TRANSFER,Current,2022-10-12 01:00:00,2022-10-12 01:04:44,To Billing Better,-182.82,0.00,GBP,COMPLETED,1689.77
TRANSFER,Current,2022-10-12 01:22:01,2022-10-12 01:22:02,Depositing savings,-0.60,0.00,GBP,COMPLETED,1689.17
CARD_PAYMENT,Current,2022-10-10 18:32:49,2022-10-12 01:28:08,News On The Wharf,-31.98,0.00,GBP,COMPLETED,1657.19
CARD_PAYMENT,Current,2022-10-10 09:41:05,2022-10-12 03:06:14,Starbucks,-5.10,0.00,GBP,COMPLETED,1652.09
CARD_PAYMENT,Current,2022-10-10 10:53:26,2022-10-12 03:06:14,Starbucks,-3.35,0.00,GBP,COMPLETED,1648.74
TRANSFER,Current,2022-10-12 07:05:33,2022-10-12 07:05:33,Depositing savings,-5.00,0.00,GBP,COMPLETED,1643.74
TRANSFER,Current,2022-10-12 10:29:39,2022-10-12 10:29:39,Depositing savings,-2.70,0.00,GBP,COMPLETED,1641.04
TRANSFER,Current,2022-10-12 10:30:59,2022-10-12 10:30:59,Depositing savings,-0.06,0.00,GBP,COMPLETED,1640.98
TRANSFER,Current,2022-10-12 13:38:52,2022-10-12 13:38:52,Depositing savings,-1.95,0.00,GBP,COMPLETED,1639.03
TRANSFER,Current,2022-10-12 14:47:13,2022-10-12 14:47:14,Depositing savings,-0.60,0.00,GBP,COMPLETED,1638.43
CARD_PAYMENT,Current,2022-10-11 15:57:46,2022-10-12 18:47:32,Scarpetta,-3.10,0.00,GBP,COMPLETED,1635.33
CARD_PAYMENT,Current,2022-10-11 11:55:28,2022-10-12 18:59:54,News On The Wharf,-15.99,0.00,GBP,COMPLETED,1619.34
TRANSFER,Current,2022-10-12 20:44:52,2022-10-12 20:44:53,Depositing savings,-0.75,0.00,GBP,COMPLETED,1618.59
CARD_PAYMENT,Current,2022-10-11 10:11:26,2022-10-12 20:46:33,Dart Charge,-2.50,0.00,GBP,COMPLETED,1616.09
TRANSFER,Current,2022-10-12 21:01:43,2022-10-12 21:01:43,Depositing savings,-0.75,0.00,GBP,COMPLETED,1615.34
CARD_PAYMENT,Current,2022-10-11 11:46:04,2022-10-12 22:42:36,Starbucks,-3.35,0.00,GBP,COMPLETED,1611.99
CARD_PAYMENT,Current,2022-10-11 09:28:35,2022-10-12 22:42:36,Starbucks,-5.10,0.00,GBP,COMPLETED,1606.89
CARD_PAYMENT,Current,2022-10-11 12:49:47,2022-10-12 22:52:20,Drivetech,-97.00,0.00,GBP,COMPLETED,1509.89
CARD_PAYMENT,Current,2022-10-11 15:32:44,2022-10-12 23:44:23,Marugame Udon,-15.05,0.00,GBP,COMPLETED,1494.84
CARD_PAYMENT,Current,2022-10-12 01:22:01,2022-10-13 00:41:35,Transport for London,-1.80,0.00,GBP,COMPLETED,1493.04
TRANSFER,Current,2022-10-13 01:21:26,2022-10-13 01:21:26,Depositing savings,-0.60,0.00,GBP,COMPLETED,1492.44
CARD_PAYMENT,Current,2022-10-11 12:11:26,2022-10-13 04:29:44,Apple,-4.99,0.00,GBP,COMPLETED,1487.45
TRANSFER,Current,2022-10-13 07:06:37,2022-10-13 07:06:37,Depositing savings,-5.00,0.00,GBP,COMPLETED,1482.45
TRANSFER,Current,2022-10-13 10:49:06,2022-10-13 10:49:06,Depositing savings,-0.60,0.00,GBP,COMPLETED,1481.85
TRANSFER,Current,2022-10-13 10:57:19,2022-10-13 10:57:20,Depositing savings,-2.70,0.00,GBP,COMPLETED,1479.15
CARD_PAYMENT,Current,2022-10-12 21:01:43,2022-10-13 12:47:29,All Bar One,-6.75,0.00,GBP,COMPLETED,1472.40
CARD_PAYMENT,Current,2022-10-12 20:44:52,2022-10-13 12:47:29,All Bar One,-6.75,0.00,GBP,COMPLETED,1465.65
TRANSFER,Current,2022-10-13 13:42:05,2022-10-13 13:42:06,Depositing savings,-2.70,0.00,GBP,COMPLETED,1462.95
CARD_PAYMENT,Current,2022-10-12 10:30:59,2022-10-13 14:27:54,News On The Wharf,-16.98,0.00,GBP,COMPLETED,1445.97
CARD_PAYMENT,Current,2022-10-12 10:29:38,2022-10-13 16:28:14,Starbucks,-5.10,0.00,GBP,COMPLETED,1440.87
CARD_PAYMENT,Current,2022-10-12 14:47:13,2022-10-13 16:28:14,Starbucks,-19.80,0.00,GBP,COMPLETED,1421.07
CARD_PAYMENT,Current,2022-10-12 13:38:51,2022-10-13 16:28:14,Starbucks,-3.35,0.00,GBP,COMPLETED,1417.72
CARD_PAYMENT,Current,2022-10-13 01:21:25,2022-10-13 18:29:12,Transport for London,-6.80,0.00,GBP,COMPLETED,1410.92
TRANSFER,Current,2022-10-14 01:24:11,2022-10-14 01:24:16,Depositing savings,-1.20,0.00,GBP,COMPLETED,1409.72
TRANSFER,Current,2022-10-14 07:09:06,2022-10-14 07:09:06,Depositing savings,-5.00,0.00,GBP,COMPLETED,1404.72
TRANSFER,Current,2022-10-14 10:00:26,2022-10-14 10:00:27,Depositing savings,-1.95,0.00,GBP,COMPLETED,1402.77
CARD_PAYMENT,Current,2022-10-13 10:49:05,2022-10-14 10:12:25,Grocery Station,-28.80,0.00,GBP,COMPLETED,1373.97
CARD_PAYMENT,Current,2022-10-13 13:42:05,2022-10-14 12:47:52,Shake Shack,-19.10,0.00,GBP,COMPLETED,1354.87
CARD_PAYMENT,Current,2022-10-13 10:57:19,2022-10-14 12:54:27,Starbucks,-5.10,0.00,GBP,COMPLETED,1349.77
TRANSFER,Current,2022-10-14 13:49:27,2022-10-14 13:49:29,Depositing savings,-2.10,0.00,GBP,COMPLETED,1347.67
TRANSFER,Current,2022-10-14 18:49:11,2022-10-14 18:49:11,Depositing savings,-0.60,0.00,GBP,COMPLETED,1347.07
CARD_PAYMENT,Current,2022-10-14 01:24:10,2022-10-14 19:06:29,Transport for London,-1.60,0.00,GBP,COMPLETED,1345.47
TRANSFER,Current,2022-10-15 01:20:01,2022-10-15 01:20:02,Depositing savings,-0.90,0.00,GBP,COMPLETED,1344.57
TRANSFER,Current,2022-10-15 07:06:35,2022-10-15 07:06:36,Depositing savings,-5.00,0.00,GBP,COMPLETED,1339.57
TRANSFER,Current,2022-10-15 11:35:49,2022-10-15 11:35:50,Depositing savings,-0.87,0.00,GBP,COMPLETED,1338.70
CARD_PAYMENT,Current,2022-10-14 13:49:26,2022-10-15 11:57:36,Starbucks,-3.30,0.00,GBP,COMPLETED,1335.40
CARD_PAYMENT,Current,2022-10-14 10:00:26,2022-10-15 11:57:36,Starbucks,-3.35,0.00,GBP,COMPLETED,1332.05
CARD_PAYMENT,Current,2022-10-14 18:49:10,2022-10-15 13:32:06,Canary Wharf,-3.80,0.00,GBP,COMPLETED,1328.25
CARD_PAYMENT,Current,2022-10-15 01:20:01,2022-10-15 14:32:37,Transport for London,-9.70,0.00,GBP,COMPLETED,1318.55
TRANSFER,Current,2022-10-15 14:50:18,2022-10-15 14:50:19,Depositing savings,-1.11,0.00,GBP,COMPLETED,1317.44
TRANSFER,Current,2022-10-15 15:21:15,2022-10-15 15:21:15,Depositing savings,-0.03,0.00,GBP,COMPLETED,1317.41
TRANSFER,Current,2022-10-16 07:05:44,2022-10-16 07:05:44,Depositing savings,-5.00,0.00,GBP,COMPLETED,1312.41
TRANSFER,Current,2022-10-16 11:07:44,2022-10-16 11:07:44,Depositing savings,-0.60,0.00,GBP,COMPLETED,1311.81
CARD_PAYMENT,Current,2022-10-15 14:50:18,2022-10-16 11:18:37,Amazon,-36.63,0.00,GBP,COMPLETED,1275.18
TRANSFER,Current,2022-10-16 13:39:17,2022-10-16 13:39:19,Depositing savings,-1.65,0.00,GBP,COMPLETED,1273.53
CARD_PAYMENT,Current,2022-10-15 15:21:15,2022-10-16 19:17:58,Apple,-44.99,0.00,GBP,COMPLETED,1228.54
TRANSFER,Current,2022-10-16 21:43:55,2022-10-16 21:43:56,Depositing savings,-1.26,0.00,GBP,COMPLETED,1227.28
TRANSFER,Current,2022-10-16 23:06:31,2022-10-16 23:06:32,Depositing savings,-3.00,0.00,GBP,COMPLETED,1224.28
TRANSFER,Current,2022-10-17 07:30:22,2022-10-17 07:30:23,Depositing savings,-5.00,0.00,GBP,COMPLETED,1219.28
TRANSFER,Current,2022-10-17 07:56:48,2022-10-17 07:56:49,Depositing savings,-2.70,0.00,GBP,COMPLETED,1216.58
CARD_PAYMENT,Current,2022-10-15 11:35:49,2022-10-17 08:57:31,BP,-46.71,0.00,GBP,COMPLETED,1169.87
CARD_PAYMENT,Current,2022-10-16 11:07:44,2022-10-17 09:07:42,Grocery Station,-28.80,0.00,GBP,COMPLETED,1141.07
TRANSFER,Current,2022-10-17 09:23:05,2022-10-17 09:23:05,Depositing savings,-2.70,0.00,GBP,COMPLETED,1138.37
TRANSFER,Current,2022-10-17 09:39:52,2022-10-17 09:39:52,Depositing savings,-0.03,0.00,GBP,COMPLETED,1138.34
CARD_PAYMENT,Current,2022-10-16 23:06:31,2022-10-17 12:15:33,EE,-27.00,0.00,GBP,COMPLETED,1111.34
CARD_PAYMENT,Current,2022-10-16 13:39:16,2022-10-17 13:37:30,GAIL's Bakery,-23.45,0.00,GBP,COMPLETED,1087.89
TRANSFER,Current,2022-10-17 14:48:31,2022-10-17 14:48:32,Depositing savings,-2.70,0.00,GBP,COMPLETED,1085.19
TRANSFER,Current,2022-10-17 18:09:48,2022-10-17 18:09:48,Depositing savings,-0.60,0.00,GBP,COMPLETED,1084.59
TRANSFER,Current,2022-10-18 01:16:55,2022-10-18 01:16:56,Depositing savings,-0.60,0.00,GBP,COMPLETED,1083.99
TRANSFER,Current,2022-10-18 07:05:17,2022-10-18 07:05:18,Depositing savings,-5.00,0.00,GBP,COMPLETED,1078.99
TRANSFER,Current,2022-10-18 08:08:52,2022-10-18 08:08:52,Depositing savings,-1.95,0.00,GBP,COMPLETED,1077.04
TRANSFER,Current,2022-10-18 08:54:51,2022-10-18 08:54:53,Depositing savings,-1.95,0.00,GBP,COMPLETED,1075.09
CARD_PAYMENT,Current,2022-10-16 21:43:55,2022-10-18 09:19:01,Amazon,-47.58,0.00,GBP,COMPLETED,1027.51
TRANSFER,Current,2022-10-18 10:08:17,2022-10-18 10:08:17,Junior negative balance correction Aleksandra,-3.10,0.00,GBP,COMPLETED,1024.41
CARD_PAYMENT,Current,2022-10-17 09:39:52,2022-10-18 11:34:23,Ryman,-4.99,0.00,GBP,COMPLETED,1019.42
CARD_PAYMENT,Current,2022-10-17 14:48:31,2022-10-18 12:06:18,Starbucks,-3.10,0.00,GBP,COMPLETED,1016.32
CARD_PAYMENT,Current,2022-10-17 09:23:04,2022-10-18 12:06:18,Starbucks,-3.10,0.00,GBP,COMPLETED,1013.22
CARD_PAYMENT,Current,2022-10-17 07:56:48,2022-10-18 12:06:19,Starbucks,-3.10,0.00,GBP,COMPLETED,1010.12
TRANSFER,Current,2022-10-18 12:06:59,2022-10-18 12:07:00,Depositing savings,-1.95,0.00,GBP,COMPLETED,1008.17
CARD_PAYMENT,Current,2022-10-18 01:16:55,2022-10-18 13:23:27,Transport for London,-1.80,0.00,GBP,COMPLETED,1006.37
TRANSFER,Current,2022-10-18 13:54:00,2022-10-18 13:54:00,Depositing savings,-3.00,0.00,GBP,COMPLETED,1003.37
TRANSFER,Current,2022-10-18 14:40:16,2022-10-18 14:40:16,Depositing savings,-1.86,0.00,GBP,COMPLETED,1001.51
TRANSFER,Current,2022-10-18 20:10:08,2022-10-18 20:10:09,Depositing savings,-0.60,0.00,GBP,COMPLETED,1000.91
TRANSFER,Current,2022-10-19 07:05:25,2022-10-19 07:05:25,Depositing savings,-5.00,0.00,GBP,COMPLETED,995.91
CARD_PAYMENT,Current,2022-10-17 18:09:47,2022-10-19 09:46:57,Riverside Supermarket,-14.80,0.00,GBP,COMPLETED,981.11
CARD_PAYMENT,Current,2022-10-18 14:40:16,2022-10-19 10:11:21,News On The Wharf,-11.38,0.00,GBP,COMPLETED,969.73
TRANSFER,Current,2022-10-19 11:13:41,2022-10-19 11:13:41,Depositing savings,-0.45,0.00,GBP,COMPLETED,969.28
TRANSFER,Current,2022-10-19 11:44:16,2022-10-19 11:44:16,Depositing savings,-1.95,0.00,GBP,COMPLETED,967.33
CARD_PAYMENT,Current,2022-10-18 12:06:59,2022-10-19 12:29:01,Starbucks,-3.35,0.00,GBP,COMPLETED,963.98
CARD_PAYMENT,Current,2022-10-18 08:54:50,2022-10-19 12:29:01,Starbucks,-3.35,0.00,GBP,COMPLETED,960.63
CARD_PAYMENT,Current,2022-10-18 08:08:52,2022-10-19 12:29:01,Starbucks,-3.35,0.00,GBP,COMPLETED,957.28
CARD_PAYMENT,Current,2022-10-18 20:10:08,2022-10-19 12:47:01,Canary Wharf,-3.80,0.00,GBP,COMPLETED,953.48
CARD_PAYMENT,Current,2022-10-18 13:53:59,2022-10-19 14:58:15,Level39,-10.00,0.00,GBP,COMPLETED,943.48
TRANSFER,Current,2022-10-19 17:24:19,2022-10-19 17:24:19,Depositing savings,-3.00,0.00,GBP,COMPLETED,940.48
TRANSFER,Current,2022-10-19 17:37:42,2022-10-19 17:37:42,Depositing savings,-0.30,0.00,GBP,COMPLETED,940.18
TRANSFER,Current,2022-10-19 19:30:46,2022-10-19 19:30:47,Depositing savings,-2.40,0.00,GBP,COMPLETED,937.78
TRANSFER,Current,2022-10-19 20:07:04,2022-10-19 20:07:05,Depositing savings,-1.50,0.00,GBP,COMPLETED,936.28
TRANSFER,Current,2022-10-19 20:14:51,2022-10-19 20:14:52,Depositing savings,-1.20,0.00,GBP,COMPLETED,935.08
TRANSFER,Current,2022-10-19 22:54:59,2022-10-19 22:54:59,Depositing savings,-3.00,0.00,GBP,COMPLETED,932.08
TRANSFER,Current,2022-10-20 01:20:23,2022-10-20 01:20:23,Depositing savings,-1.20,0.00,GBP,COMPLETED,930.88
TRANSFER,Current,2022-10-20 07:06:56,2022-10-20 07:06:57,Depositing savings,-5.00,0.00,GBP,COMPLETED,925.88
CARD_PAYMENT,Current,2022-10-19 17:37:41,2022-10-20 11:09:25,Hazev Restaurant,-7.90,0.00,GBP,COMPLETED,917.98
CARD_PAYMENT,Current,2022-10-19 17:24:19,2022-10-20 11:09:25,Hazev Restaurant,-18.00,0.00,GBP,COMPLETED,899.98
CARD_PAYMENT,Current,2022-10-19 11:44:16,2022-10-20 12:42:10,Starbucks,-3.35,0.00,GBP,COMPLETED,896.63
CARD_PAYMENT,Current,2022-10-19 22:54:58,2022-10-20 13:07:43,EE,-18.00,0.00,GBP,COMPLETED,878.63
CARD_PAYMENT,Current,2022-10-19 20:07:04,2022-10-20 14:15:04,The Grapes,-6.50,0.00,GBP,COMPLETED,872.13
CARD_PAYMENT,Current,2022-10-20 01:20:23,2022-10-20 14:44:36,Transport for London,-1.60,0.00,GBP,COMPLETED,870.53
TRANSFER,Current,2022-10-20 15:35:56,2022-10-20 15:35:56,Depositing savings,-1.50,0.00,GBP,COMPLETED,869.03
TRANSFER,Current,2022-10-20 18:32:16,2022-10-20 18:32:16,Depositing savings,-2.55,0.00,GBP,COMPLETED,866.48
TRANSFER,Current,2022-10-21 01:21:13,2022-10-21 01:21:14,Depositing savings,-1.20,0.00,GBP,COMPLETED,865.28
TRANSFER,Current,2022-10-21 07:09:09,2022-10-21 07:09:09,Depositing savings,-5.00,0.00,GBP,COMPLETED,860.28
TRANSFER,Current,2022-10-21 09:51:33,2022-10-21 09:51:34,Depositing savings,-0.75,0.00,GBP,COMPLETED,859.53
CARD_PAYMENT,Current,2022-10-19 11:13:40,2022-10-21 10:49:30,Pret,-12.85,0.00,GBP,COMPLETED,846.68
TRANSFER,Current,2022-10-21 11:04:52,2022-10-21 11:04:52,Depositing savings,-1.71,0.00,GBP,COMPLETED,844.97
CARD_PAYMENT,Current,2022-10-19 20:14:51,2022-10-21 11:16:55,Riverside Supermarket,-40.60,0.00,GBP,COMPLETED,804.37
CARD_PAYMENT,Current,2022-10-20 18:32:15,2022-10-21 12:23:49,Tesco,-3.15,0.00,GBP,COMPLETED,801.22
TRANSFER,Current,2022-10-21 12:33:01,2022-10-21 12:33:01,Depositing savings,-1.50,0.00,GBP,COMPLETED,799.72
TRANSFER,Current,2022-10-21 13:14:37,2022-10-21 13:14:38,Depositing savings,-2.79,0.00,GBP,COMPLETED,796.93
CARD_PAYMENT,Current,2022-10-19 19:30:46,2022-10-21 13:51:53,No 35 Mackenzie Walk,-7.20,0.00,GBP,COMPLETED,789.73
CARD_PAYMENT,Current,2022-10-20 15:35:55,2022-10-21 14:23:56,Starbucks,-2.50,0.00,GBP,COMPLETED,787.23
CARD_PAYMENT,Current,2022-10-21 01:21:13,2022-10-21 18:12:31,Transport for London,-1.60,0.00,GBP,COMPLETED,785.63
TRANSFER,Current,2022-10-22 03:20:23,2022-10-22 03:20:24,Depositing savings,-0.03,0.00,GBP,COMPLETED,785.60
TRANSFER,Current,2022-10-22 06:10:38,2022-10-22 06:10:38,To GBP,18.69,0.00,GBP,COMPLETED,804.29
TRANSFER,Current,2022-10-22 06:11:26,2022-10-22 06:11:26,Withdrawing savings,435.75,0.00,GBP,COMPLETED,1240.04
TRANSFER,Current,2022-10-22 06:11:56,2022-10-22 06:11:57,Withdrawing savings,2359.53,0.00,GBP,COMPLETED,3599.57
TRANSFER,Current,2022-10-22 07:05:42,2022-10-22 07:05:43,Depositing savings,-5.00,0.00,GBP,COMPLETED,3594.57
CARD_PAYMENT,Current,2022-10-21 11:04:52,2022-10-22 09:51:41,Amazon,-4.43,0.00,GBP,COMPLETED,3590.14
CARD_PAYMENT,Current,2022-10-21 13:14:37,2022-10-22 10:28:20,News On The Wharf,-17.07,0.00,GBP,COMPLETED,3573.07
CARD_PAYMENT,Current,2022-10-21 12:33:01,2022-10-22 12:31:33,Starbucks,-2.50,0.00,GBP,COMPLETED,3570.57
CARD_PAYMENT,Current,2022-10-21 09:51:33,2022-10-22 13:03:18,Starbucks,-1.75,0.00,GBP,COMPLETED,3568.82
TRANSFER,Current,2022-10-22 13:34:09,2022-10-22 13:34:09,Depositing savings,-3.00,0.00,GBP,COMPLETED,3565.82
TRANSFER,Current,2022-10-22 16:42:01,2022-10-22 16:42:02,Depositing savings,-0.06,0.00,GBP,COMPLETED,3565.76
TRANSFER,Current,2022-10-23 07:05:32,2022-10-23 07:05:33,Depositing savings,-5.00,0.00,GBP,COMPLETED,3560.76
CARD_PAYMENT,Current,2022-10-22 16:42:01,2022-10-23 10:54:25,The Castle Inn,-52.98,0.00,GBP,COMPLETED,3507.78
CARD_PAYMENT,Current,2022-10-22 13:34:09,2022-10-23 10:59:12,Foxhills Spa,-70.00,0.00,GBP,COMPLETED,3437.78
TRANSFER,Current,2022-10-23 16:03:35,2022-10-23 16:03:36,Depositing savings,-0.03,0.00,GBP,COMPLETED,3437.75
CARD_PAYMENT,Current,2022-10-22 03:20:23,2022-10-23 18:39:48,Apple,-6.99,0.00,GBP,COMPLETED,3430.76
TRANSFER,Current,2022-10-24 07:30:39,2022-10-24 07:30:39,Depositing savings,-5.00,0.00,GBP,COMPLETED,3425.76
TRANSFER,Current,2022-10-24 10:32:36,2022-10-24 10:32:37,Depositing savings,-1.95,0.00,GBP,COMPLETED,3423.81
CARD_PAYMENT,Current,2022-10-23 16:03:35,2022-10-24 10:43:13,Amazon,-6.99,0.00,GBP,COMPLETED,3416.82
TRANSFER,Current,2022-10-24 11:17:07,2022-10-24 11:17:08,Depositing savings,-3.00,0.00,GBP,COMPLETED,3413.82
TRANSFER,Current,2022-10-24 12:38:16,2022-10-24 12:38:17,Depositing savings,-1.50,0.00,GBP,COMPLETED,3412.32
TRANSFER,Current,2022-10-24 15:12:03,2022-10-24 15:12:04,Depositing savings,-3.00,0.00,GBP,COMPLETED,3409.32
TRANSFER,Current,2022-10-24 15:41:26,2022-10-24 15:44:38,Depositing savings,-2.88,0.00,GBP,COMPLETED,3406.44
TRANSFER,Current,2022-10-24 18:12:42,2022-10-24 18:12:43,Depositing savings,-0.12,0.00,GBP,COMPLETED,3406.32
TRANSFER,Current,2022-10-24 20:22:46,2022-10-24 20:22:46,Depositing savings,-2.55,0.00,GBP,COMPLETED,3403.77
TRANSFER,Current,2022-10-24 20:46:41,2022-10-24 20:46:41,To Aleksandra Balabanova,-100.00,0.00,GBP,COMPLETED,3303.77
TRANSFER,Current,2022-10-25 01:15:23,2022-10-25 01:15:23,Depositing savings,-2.70,0.00,GBP,COMPLETED,3301.07
TRANSFER,Current,2022-10-25 07:05:42,2022-10-25 07:05:43,Depositing savings,-5.00,0.00,GBP,COMPLETED,3296.07
TRANSFER,Current,2022-10-25 08:54:51,2022-10-25 08:54:51,Depositing savings,-1.95,0.00,GBP,COMPLETED,3294.12
CARD_PAYMENT,Current,2022-10-24 18:12:42,2022-10-25 12:40:55,News On The Wharf,-33.96,0.00,GBP,COMPLETED,3260.16
CARD_PAYMENT,Current,2022-10-24 11:17:07,2022-10-25 13:41:33,Adam Grooming Atelier,-30.00,0.00,GBP,COMPLETED,3230.16
CARD_PAYMENT,Current,2022-10-24 10:32:36,2022-10-25 15:09:12,Starbucks,-3.35,0.00,GBP,COMPLETED,3226.81
CARD_PAYMENT,Current,2022-10-24 12:38:16,2022-10-25 15:09:12,Starbucks,-2.50,0.00,GBP,COMPLETED,3224.31
CARD_PAYMENT,Current,2022-10-24 20:22:46,2022-10-25 15:37:02,Marks & Spencer,-19.15,0.00,GBP,COMPLETED,3205.16
CARD_PAYMENT,Current,2022-10-24 15:41:25,2022-10-25 16:06:33,Canary Wharf,-13.04,0.00,GBP,COMPLETED,3192.12
CARD_PAYMENT,Current,2022-10-25 01:15:23,2022-10-25 16:56:58,Transport for London,-14.10,0.00,GBP,COMPLETED,3178.02
CARD_PAYMENT,Current,2022-10-24 15:12:03,2022-10-26 00:02:55,Onetwotrip,-376.00,0.00,GBP,COMPLETED,2802.02
TRANSFER,Current,2022-10-26 01:00:00,2022-10-26 01:04:23,To Tfl Congestn Chrge,-37.50,0.00,GBP,COMPLETED,2764.52
TRANSFER,Current,2022-10-26 01:19:08,2022-10-26 01:19:08,Depositing savings,-0.90,0.00,GBP,COMPLETED,2763.62
TRANSFER,Current,2022-10-26 07:05:52,2022-10-26 07:05:52,Depositing savings,-5.00,0.00,GBP,COMPLETED,2758.62
TRANSFER,Current,2022-10-26 08:18:07,2022-10-26 08:18:07,Depositing savings,-1.95,0.00,GBP,COMPLETED,2756.67
TRANSFER,Current,2022-10-26 08:21:21,2022-10-26 08:21:22,Depositing savings,-0.72,0.00,GBP,COMPLETED,2755.95
TRANSFER,Current,2022-10-26 09:51:05,2022-10-26 09:51:05,Depositing savings,-1.95,0.00,GBP,COMPLETED,2754.00
TRANSFER,Current,2022-10-26 11:49:40,2022-10-26 11:49:41,Depositing savings,-3.00,0.00,GBP,COMPLETED,2751.00
TRANSFER,Current,2022-10-26 11:59:49,2022-10-26 11:59:50,Depositing savings,-2.70,0.00,GBP,COMPLETED,2748.30
CARD_PAYMENT,Current,2022-10-25 08:54:50,2022-10-26 13:21:15,Starbucks,-3.35,0.00,GBP,COMPLETED,2744.95
TRANSFER,Current,2022-10-26 15:12:55,2022-10-26 15:13:00,Depositing savings,-0.75,0.00,GBP,COMPLETED,2744.20
CARD_PAYMENT,Current,2022-10-26 01:19:08,2022-10-26 15:55:18,Transport for London,-7.70,0.00,GBP,COMPLETED,2736.50
TOPUP,Current,2022-10-26 16:19:04,2022-10-26 16:19:05,Payment from Balabanov M,300000.00,0.00,GBP,COMPLETED,302736.50
TRANSFER,Current,2022-10-26 16:38:46,2022-10-26 16:38:46,To GBP Home,-300000.00,0.00,GBP,COMPLETED,2736.50
TRANSFER,Current,2022-10-27 01:19:28,2022-10-27 01:19:28,Depositing savings,-0.60,0.00,GBP,COMPLETED,2735.90
TRANSFER,Current,2022-10-27 07:07:01,2022-10-27 07:07:01,Depositing savings,-5.00,0.00,GBP,COMPLETED,2730.90
TRANSFER,Current,2022-10-27 08:32:48,2022-10-27 08:32:48,Depositing savings,-1.95,0.00,GBP,COMPLETED,2728.95
CARD_PAYMENT,Current,2022-10-26 08:21:21,2022-10-27 10:13:50,News On The Wharf,-22.76,0.00,GBP,COMPLETED,2706.19
TRANSFER,Current,2022-10-27 10:28:58,2022-10-27 10:28:58,Depositing savings,-1.95,0.00,GBP,COMPLETED,2704.24
CARD_PAYMENT,Current,2022-10-26 11:59:49,2022-10-27 12:26:39,Shake Shack,-19.10,0.00,GBP,COMPLETED,2685.14
CARD_PAYMENT,Current,2022-10-26 09:51:04,2022-10-27 12:29:41,Starbucks,-3.35,0.00,GBP,COMPLETED,2681.79
CARD_PAYMENT,Current,2022-10-26 08:18:07,2022-10-27 12:29:41,Starbucks,-3.35,0.00,GBP,COMPLETED,2678.44
CARD_PAYMENT,Current,2022-10-26 15:12:36,2022-10-27 12:29:41,Starbucks,-1.75,0.00,GBP,COMPLETED,2676.69
CARD_PAYMENT,Current,2022-10-26 11:49:40,2022-10-27 13:03:27,Malmin Dental,-30.00,0.00,GBP,COMPLETED,2646.69
TRANSFER,Current,2022-10-27 13:22:11,2022-10-27 13:22:27,Depositing savings,-3.00,0.00,GBP,COMPLETED,2643.69
TRANSFER,Current,2022-10-27 16:22:05,2022-10-27 16:22:17,Depositing savings,-3.00,0.00,GBP,COMPLETED,2640.69
CARD_PAYMENT,Current,2022-10-27 01:19:28,2022-10-27 19:11:21,Transport for London,-1.80,0.00,GBP,COMPLETED,2638.89
TRANSFER,Current,2022-10-28 01:22:21,2022-10-28 01:22:22,Depositing savings,-0.60,0.00,GBP,COMPLETED,2638.29
TRANSFER,Current,2022-10-28 07:09:48,2022-10-28 07:09:49,Depositing savings,-5.00,0.00,GBP,COMPLETED,2633.29
TRANSFER,Current,2022-10-28 09:15:32,2022-10-28 09:15:40,Depositing savings,-1.95,0.00,GBP,COMPLETED,2631.34
TRANSFER,Current,2022-10-28 09:18:23,2022-10-28 09:18:24,Depositing savings,-0.60,0.00,GBP,COMPLETED,2630.74
TRANSFER,Current,2022-10-28 11:26:12,2022-10-28 11:26:27,Depositing savings,-2.10,0.00,GBP,COMPLETED,2628.64
CARD_PAYMENT,Current,2022-10-27 08:32:47,2022-10-28 12:15:21,Starbucks,-3.35,0.00,GBP,COMPLETED,2625.29
CARD_PAYMENT,Current,2022-10-27 10:28:58,2022-10-28 12:15:21,Starbucks,-3.35,0.00,GBP,COMPLETED,2621.94
CARD_PAYMENT,Current,2022-10-27 16:21:55,2022-10-28 12:32:05,Malmin Dental,-55.00,0.00,GBP,COMPLETED,2566.94
CARD_PAYMENT,Current,2022-10-28 01:22:21,2022-10-28 14:06:46,Transport for London,-1.80,0.00,GBP,COMPLETED,2565.14
TRANSFER,Current,2022-10-28 17:32:39,2022-10-28 17:32:57,Depositing savings,-0.30,0.00,GBP,COMPLETED,2564.84
CARD_PAYMENT,Current,2022-10-27 13:20:32,2022-10-28 19:06:11,Level39,-10.00,0.00,GBP,COMPLETED,2554.84
TRANSFER,Current,2022-10-28 19:06:09,2022-10-28 19:06:32,Depositing savings,-0.06,0.00,GBP,COMPLETED,2554.78
TRANSFER,Current,2022-10-28 20:04:03,2022-10-28 20:04:18,Depositing savings,-2.31,0.00,GBP,COMPLETED,2552.47
TRANSFER,Current,2022-10-28 20:37:24,2022-10-28 20:37:24,Depositing savings,-2.70,0.00,GBP,COMPLETED,2549.77
FEE,Current,2022-10-29 00:03:19,2022-10-29 00:03:19,Metal plan fee,-12.99,0.00,GBP,COMPLETED,2536.78
TRANSFER,Current,2022-10-29 07:06:01,2022-10-29 07:06:02,Depositing savings,-5.00,0.00,GBP,COMPLETED,2531.78
TRANSFER,Current,2022-10-29 12:18:43,2022-10-29 12:18:54,Depositing savings,-1.80,0.00,GBP,COMPLETED,2529.98
CARD_PAYMENT,Current,2022-10-28 09:15:19,2022-10-29 12:21:20,Starbucks,-3.35,0.00,GBP,COMPLETED,2526.63
CARD_PAYMENT,Current,2022-10-28 09:18:23,2022-10-29 12:21:20,Starbucks,-19.80,0.00,GBP,COMPLETED,2506.83
CARD_PAYMENT,Current,2022-10-28 11:26:10,2022-10-29 12:21:20,Starbucks,-3.30,0.00,GBP,COMPLETED,2503.53
TRANSFER,Current,2022-10-29 12:35:03,2022-10-29 12:35:03,Depositing savings,-0.18,0.00,GBP,COMPLETED,2503.35
CARD_PAYMENT,Current,2022-10-28 17:32:24,2022-10-29 13:50:27,The Parlour,-6.90,0.00,GBP,COMPLETED,2496.45
TRANSFER,Current,2022-10-29 14:07:24,2022-10-29 14:07:25,Depositing savings,-0.03,0.00,GBP,COMPLETED,2496.42
TRANSFER,Current,2022-10-30 03:00:26,2022-10-30 03:00:27,Depositing savings,-0.03,0.00,GBP,COMPLETED,2496.39
TRANSFER,Current,2022-10-30 06:06:09,2022-10-30 06:06:09,Depositing savings,-5.00,0.00,GBP,COMPLETED,2491.39
TRANSFER,Current,2022-10-30 08:40:10,2022-10-30 08:40:10,Withdrawing savings,1000.00,0.00,GBP,COMPLETED,3491.39
TRANSFER,Current,2022-10-30 08:41:13,2022-10-30 08:41:15,To Holly Michael,-2450.00,0.00,GBP,COMPLETED,1041.39
CARD_PAYMENT,Current,2022-10-28 20:37:23,2022-10-30 10:16:16,Riverside Supermarket,-35.10,0.00,GBP,COMPLETED,1006.29
CARD_PAYMENT,Current,2022-10-29 14:07:24,2022-10-30 10:26:20,Amazon Prime,-8.99,0.00,GBP,COMPLETED,997.30
CARD_PAYMENT,Current,2022-10-28 20:04:03,2022-10-30 13:03:23,No 35 Mackenzie Walk,-36.23,0.00,GBP,COMPLETED,961.07
CARD_PAYMENT,Current,2022-10-28 19:06:04,2022-10-30 13:03:23,No 35 Mackenzie Walk,-83.98,0.00,GBP,COMPLETED,877.09
CARD_PAYMENT,Current,2022-10-29 12:18:42,2022-10-30 13:29:44,Carluccios Wimbledon,-31.40,0.00,GBP,COMPLETED,845.69
CARD_PAYMENT,Current,2022-10-30 03:00:26,2022-10-30 14:35:53,Netflix,-10.99,0.00,GBP,COMPLETED,834.70
CARD_PAYMENT,Current,2022-10-29 12:35:02,2022-10-30 15:46:26,Shell,-65.94,0.00,GBP,COMPLETED,768.76
TRANSFER,Current,2022-10-31 00:00:00,2022-10-31 01:02:15,To Virgin Active,-147.00,0.00,GBP,COMPLETED,621.76
TRANSFER,Current,2022-10-31 06:32:07,2022-10-31 06:37:22,Depositing savings,-5.00,0.00,GBP,COMPLETED,616.76
TRANSFER,Current,2022-10-31 11:50:07,2022-10-31 11:50:08,Depositing savings,-0.66,0.00,GBP,COMPLETED,616.10
TRANSFER,Current,2022-10-31 20:17:42,2022-10-31 20:17:43,Depositing savings,-2.19,0.00,GBP,COMPLETED,613.91
TRANSFER,Current,2022-11-01 01:15:54,2022-11-01 01:15:55,Depositing savings,-2.40,0.00,GBP,COMPLETED,611.51
TRANSFER,Current,2022-11-01 06:11:28,2022-11-01 06:11:29,Depositing savings,-5.00,0.00,GBP,COMPLETED,606.51
TOPUP,Current,2022-11-01 10:27:22,2022-11-01 10:27:23,Payment from Balabanov M,6000.00,0.00,GBP,COMPLETED,6606.51
CARD_PAYMENT,Current,2022-10-31 11:50:07,2022-11-01 13:17:07,WHSmith,-9.78,0.00,GBP,COMPLETED,6596.73
TRANSFER,Current,2022-11-01 16:25:18,2022-11-01 16:25:18,Depositing savings,-2.85,0.00,GBP,COMPLETED,6593.88
CARD_PAYMENT,Current,2022-11-01 01:15:54,2022-11-02 02:52:51,Transport for London,-3.20,0.00,GBP,COMPLETED,6590.68
TRANSFER,Current,2022-11-02 06:06:10,2022-11-02 06:06:10,Depositing savings,-5.00,0.00,GBP,COMPLETED,6585.68
TRANSFER,Current,2022-11-02 08:01:39,2022-11-02 08:01:39,To Natalia Balabanova,-2000.00,0.00,GBP,COMPLETED,4585.68
TRANSFER,Current,2022-11-02 08:01:39,2022-11-02 08:01:39,To Aleksandra Balabanova,-600.00,0.00,GBP,COMPLETED,3985.68
CARD_PAYMENT,Current,2022-10-31 20:17:42,2022-11-02 12:48:35,Loja Das Conservas,-40.27,0.00,GBP,COMPLETED,3945.41
CARD_PAYMENT,Current,2022-11-01 16:25:18,2022-11-02 12:49:19,GMS Store Chiado,-180.05,0.00,GBP,COMPLETED,3765.36
TRANSFER,Current,2022-11-02 23:22:25,2022-11-02 23:22:25,Depositing savings,-0.27,0.00,GBP,COMPLETED,3765.09
TRANSFER,Current,2022-11-03 06:07:18,2022-11-03 06:07:18,Depositing savings,-5.00,0.00,GBP,COMPLETED,3760.09
TRANSFER,Current,2022-11-03 14:34:41,2022-11-03 14:34:41,Depositing savings,-1.50,0.00,GBP,COMPLETED,3758.59
TRANSFER,Current,2022-11-03 15:34:04,2022-11-03 15:34:05,Depositing savings,-0.12,0.00,GBP,COMPLETED,3758.47
TRANSFER,Current,2022-11-04 06:09:32,2022-11-04 06:09:32,Depositing savings,-5.00,0.00,GBP,COMPLETED,3753.47
CARD_PAYMENT,Current,2022-11-04 07:55:56,,Frn* Hold.free-Now.com,-8.91,0.00,GBP,REVERTED,
TRANSFER,Current,2022-11-04 07:55:56,2022-11-04 07:55:57,Depositing savings,-0.27,0.00,GBP,COMPLETED,3753.20
CARD_PAYMENT,Current,2022-11-04 07:58:34,,Frn*hold.free-Now.com,-11.58,0.00,GBP,REVERTED,
TRANSFER,Current,2022-11-04 07:58:34,2022-11-04 07:58:35,Depositing savings,-1.26,0.00,GBP,COMPLETED,3751.94
CARD_PAYMENT,Current,2022-11-03 14:34:41,2022-11-04 11:02:55,Web Summit,-3.50,0.00,GBP,COMPLETED,3748.44
CARD_PAYMENT,Current,2022-11-03 15:34:04,2022-11-04 11:02:55,Web Summit,-13.96,0.00,GBP,COMPLETED,3734.48
CARD_PAYMENT,Current,2022-11-02 23:22:24,2022-11-04 11:06:01,Bacchanal,-50.91,0.00,GBP,COMPLETED,3683.57
TRANSFER,Current,2022-11-04 15:34:14,2022-11-04 15:34:16,Depositing savings,-1.53,0.00,GBP,COMPLETED,3682.04
TRANSFER,Current,2022-11-04 15:35:41,2022-11-04 15:35:42,Depositing savings,-0.51,0.00,GBP,COMPLETED,3681.53
TRANSFER,Current,2022-11-04 16:47:37,2022-11-04 16:47:38,Depositing savings,-0.75,0.00,GBP,COMPLETED,3680.78
TRANSFER,Current,2022-11-04 16:54:29,2022-11-04 16:54:34,Depositing savings,-1.95,0.00,GBP,COMPLETED,3678.83
TRANSFER,Current,2022-11-04 17:03:44,2022-11-04 17:03:58,Depositing savings,-0.72,0.00,GBP,COMPLETED,3678.11
TRANSFER,Current,2022-11-04 23:37:29,2022-11-04 23:37:29,Depositing savings,-1.23,0.00,GBP,COMPLETED,3676.88
TRANSFER,Current,2022-11-05 06:06:42,2022-11-05 06:06:42,Depositing savings,-5.00,0.00,GBP,COMPLETED,3671.88
CARD_PAYMENT,Current,2022-11-05 08:33:06,,Frn* Hold.free-Now.com,-14.92,0.15,GBP,REVERTED,
TRANSFER,Current,2022-11-05 08:33:06,2022-11-05 08:33:07,Depositing savings,-0.24,0.00,GBP,COMPLETED,3671.64
CARD_PAYMENT,Current,2022-11-04 15:34:13,2022-11-05 10:00:57,Frn* Hold.free-Now.com,-10.49,0.00,GBP,COMPLETED,3661.15
TRANSFER,Current,2022-11-05 10:30:25,2022-11-05 10:30:25,Depositing savings,-2.28,0.00,GBP,COMPLETED,3658.87
CARD_PAYMENT,Current,2022-11-04 15:35:40,2022-11-05 11:30:37,Websummit,-4.83,0.00,GBP,COMPLETED,3654.04
CARD_PAYMENT,Current,2022-11-04 16:47:37,2022-11-05 14:45:06,Loja Das Conservas,-12.75,0.00,GBP,COMPLETED,3641.29
CARD_PAYMENT,Current,2022-11-04 16:54:27,2022-11-05 14:45:18,Mercearia Perola Ars,-13.35,0.00,GBP,COMPLETED,3627.94
CARD_PAYMENT,Current,2022-11-04 17:03:31,2022-11-05 14:45:39,Hotel Ferraria Xvi,-1.76,0.00,GBP,COMPLETED,3626.18
TRANSFER,Current,2022-11-05 15:41:28,2022-11-05 15:41:28,Depositing savings,-0.33,0.00,GBP,COMPLETED,3625.85
TRANSFER,Current,2022-11-05 15:45:00,2022-11-05 15:45:00,Depositing savings,-0.78,0.00,GBP,COMPLETED,3625.07
TRANSFER,Current,2022-11-05 22:47:27,2022-11-05 22:47:28,Depositing savings,-3.00,0.00,GBP,COMPLETED,3622.07
TRANSFER,Current,2022-11-06 01:10:58,2022-11-06 01:10:58,Depositing savings,-1.20,0.00,GBP,COMPLETED,3620.87
TRANSFER,Current,2022-11-06 06:05:47,2022-11-06 06:05:48,Depositing savings,-5.00,0.00,GBP,COMPLETED,3615.87
TRANSFER,Current,2022-11-06 11:40:03,2022-11-06 11:40:03,Depositing savings,-0.03,0.00,GBP,COMPLETED,3615.84
CARD_PAYMENT,Current,2022-11-05 15:44:59,2022-11-06 11:46:52,News On The Wharf,-54.74,0.00,GBP,COMPLETED,3561.10
CARD_PAYMENT,Current,2022-11-04 23:37:28,2022-11-06 12:17:32,McDonald's,-12.59,0.13,GBP,COMPLETED,3548.38
CARD_PAYMENT,Current,2022-11-05 15:41:28,2022-11-06 12:42:47,Boots,-6.89,0.00,GBP,COMPLETED,3541.49
CARD_PAYMENT,Current,2022-11-05 22:47:27,2022-11-06 14:10:53,EE,-25.00,0.00,GBP,COMPLETED,3516.49
CARD_PAYMENT,Current,2022-11-05 10:30:24,2022-11-06 14:45:34,London Club,-12.24,0.12,GBP,COMPLETED,3504.13
TRANSFER,Current,2022-11-06 19:45:08,2022-11-06 19:45:09,Depositing savings,-0.63,0.00,GBP,COMPLETED,3503.50
TRANSFER,Current,2022-11-07 06:31:48,2022-11-07 06:31:48,Depositing savings,-5.00,0.00,GBP,COMPLETED,3498.50
TRANSFER,Current,2022-11-07 08:45:33,2022-11-07 08:45:33,Depositing savings,-2.55,0.00,GBP,COMPLETED,3495.95
CARD_PAYMENT,Current,2022-11-06 01:10:58,2022-11-07 09:50:20,Transport for London,-27.60,0.00,GBP,COMPLETED,3468.35
TRANSFER,Current,2022-11-07 10:01:05,2022-11-07 10:01:05,Depositing savings,-2.10,0.00,GBP,COMPLETED,3466.25
TRANSFER,Current,2022-11-07 11:37:11,2022-11-07 11:37:12,Depositing savings,-0.75,0.00,GBP,COMPLETED,3465.50
TRANSFER,Current,2022-11-07 16:25:22,2022-11-07 16:25:23,Depositing savings,-1.35,0.00,GBP,COMPLETED,3464.15
TRANSFER,Current,2022-11-07 16:36:23,2022-11-07 16:36:23,Depositing savings,-2.10,0.00,GBP,COMPLETED,3462.05
TRANSFER,Current,2022-11-07 16:43:42,2022-11-07 16:43:43,Depositing savings,-1.20,0.00,GBP,COMPLETED,3460.85
TRANSFER,Current,2022-11-07 17:02:16,2022-11-07 17:02:17,Depositing savings,-0.96,0.00,GBP,COMPLETED,3459.89
TRANSFER,Current,2022-11-07 17:05:42,2022-11-07 17:05:42,Depositing savings,-0.60,0.00,GBP,COMPLETED,3459.29
CARD_PAYMENT,Current,2022-11-06 11:40:02,2022-11-07 19:29:56,Apple,-14.99,0.00,GBP,COMPLETED,3444.30
CARD_PAYMENT,Current,2022-11-06 19:45:08,2022-11-07 22:09:57,Apple,-1.79,0.00,GBP,COMPLETED,3442.51
TRANSFER,Current,2022-11-08 01:12:46,2022-11-08 01:12:46,Depositing savings,-1.80,0.00,GBP,COMPLETED,3440.71
TRANSFER,Current,2022-11-08 06:05:31,2022-11-08 06:05:32,Depositing savings,-5.00,0.00,GBP,COMPLETED,3435.71
CARD_PAYMENT,Current,2022-11-07 17:02:15,2022-11-08 09:27:19,News On The Wharf,-21.68,0.00,GBP,COMPLETED,3414.03
TRANSFER,Current,2022-11-08 09:58:27,2022-11-08 09:58:28,Depositing savings,-1.95,0.00,GBP,COMPLETED,3412.08
CARD_PAYMENT,Current,2022-11-07 16:25:22,2022-11-08 10:34:20,Hazev Restaurant,-29.55,0.00,GBP,COMPLETED,3382.53
CARD_PAYMENT,Current,2022-11-07 16:36:22,2022-11-08 10:34:20,Hazev Restaurant,-10.30,0.00,GBP,COMPLETED,3372.23
CARD_PAYMENT,Current,2022-11-07 16:43:42,2022-11-08 10:34:20,Hazev Restaurant,-2.60,0.00,GBP,COMPLETED,3369.63
CARD_PAYMENT,Current,2022-11-07 08:45:32,2022-11-08 12:10:00,Starbucks,-23.15,0.00,GBP,COMPLETED,3346.48
CARD_PAYMENT,Current,2022-11-07 10:01:04,2022-11-08 12:10:00,Starbucks,-3.30,0.00,GBP,COMPLETED,3343.18
CARD_PAYMENT,Current,2022-11-07 17:05:41,2022-11-08 13:06:00,Canary Wharf,-4.80,0.00,GBP,COMPLETED,3338.38
TRANSFER,Current,2022-11-08 17:36:31,2022-11-08 17:36:32,Depositing savings,-0.72,0.00,GBP,COMPLETED,3337.66
TRANSFER,Current,2022-11-08 18:11:25,2022-11-08 18:11:26,Depositing savings,-0.06,0.00,GBP,COMPLETED,3337.60
CARD_PAYMENT,Current,2022-11-08 01:12:45,2022-11-08 22:35:33,Transport for London,-3.40,0.00,GBP,COMPLETED,3334.20
TRANSFER,Current,2022-11-09 01:18:40,2022-11-09 01:18:41,Depositing savings,-0.60,0.00,GBP,COMPLETED,3333.60
TRANSFER,Current,2022-11-09 06:05:31,2022-11-09 06:05:31,Depositing savings,-5.00,0.00,GBP,COMPLETED,3328.60
TRANSFER,Current,2022-11-09 08:57:11,2022-11-09 08:57:12,Depositing savings,-2.10,0.00,GBP,COMPLETED,3326.50
CARD_PAYMENT,Current,2022-11-08 18:11:25,2022-11-09 09:58:05,News On The Wharf,-31.98,0.00,GBP,COMPLETED,3294.52
CARD_PAYMENT,Current,2022-11-08 17:36:31,2022-11-09 09:58:05,News On The Wharf,-22.76,0.00,GBP,COMPLETED,3271.76
TRANSFER,Current,2022-11-09 11:53:00,2022-11-09 11:53:01,Depositing savings,-2.40,0.00,GBP,COMPLETED,3269.36
CARD_PAYMENT,Current,2022-11-08 09:58:27,2022-11-09 11:53:59,Starbucks,-3.35,0.00,GBP,COMPLETED,3266.01
CARD_PAYMENT,Current,2022-11-07 11:37:11,2022-11-09 12:09:26,Marugame Udon,-13.75,0.00,GBP,COMPLETED,3252.26
CARD_PAYMENT,Current,2022-11-09 01:18:40,2022-11-09 13:52:12,Transport for London,-7.80,0.00,GBP,COMPLETED,3244.46
TRANSFER,Current,2022-11-10 01:17:47,2022-11-10 01:17:48,Depositing savings,-1.20,0.00,GBP,COMPLETED,3243.26
TRANSFER,Current,2022-11-10 06:07:51,2022-11-10 06:07:51,Depositing savings,-5.00,0.00,GBP,COMPLETED,3238.26
CARD_PAYMENT,Current,2022-11-09 11:53:00,2022-11-10 12:10:19,Shake Shack,-17.20,0.00,GBP,COMPLETED,3221.06
CARD_PAYMENT,Current,2022-11-09 08:57:11,2022-11-10 12:16:52,Starbucks,-3.30,0.00,GBP,COMPLETED,3217.76
CARD_PAYMENT,Current,2022-11-10 01:17:47,2022-11-10 12:46:55,Transport for London,-1.60,0.00,GBP,COMPLETED,3216.16
TRANSFER,Current,2022-11-11 00:00:00,2022-11-11 01:06:19,To Billing Better,-182.82,0.00,GBP,COMPLETED,3033.34
TRANSFER,Current,2022-11-11 06:09:32,2022-11-11 06:09:32,Depositing savings,-5.00,0.00,GBP,COMPLETED,3028.34
TRANSFER,Current,2022-11-11 12:09:13,2022-11-11 12:09:14,Depositing savings,-0.03,0.00,GBP,COMPLETED,3028.31
TRANSFER,Current,2022-11-11 12:24:36,2022-11-11 12:24:36,Depositing savings,-0.78,0.00,GBP,COMPLETED,3027.53
TRANSFER,Current,2022-11-11 15:01:54,2022-11-11 15:01:55,Depositing savings,-0.60,0.00,GBP,COMPLETED,3026.93
TRANSFER,Current,2022-11-12 06:05:57,2022-11-12 06:05:57,Depositing savings,-5.00,0.00,GBP,COMPLETED,3021.93
CARD_PAYMENT,Current,2022-11-11 12:24:35,2022-11-12 10:17:18,News On The Wharf,-54.74,0.00,GBP,COMPLETED,2967.19
CARD_PAYMENT,Current,2022-11-11 15:01:53,2022-11-12 13:23:34,Canary Wharf,-4.80,0.00,GBP,COMPLETED,2962.39
CARD_PAYMENT,Current,2022-11-11 12:09:13,2022-11-12 21:34:06,Apple,-4.99,0.00,GBP,COMPLETED,2957.40
TRANSFER,Current,2022-11-13 06:05:36,2022-11-13 06:05:36,Depositing savings,-5.00,0.00,GBP,COMPLETED,2952.40
TRANSFER,Current,2022-11-14 06:31:53,2022-11-14 06:31:54,Depositing savings,-5.00,0.00,GBP,COMPLETED,2947.40
TRANSFER,Current,2022-11-14 10:24:11,2022-11-14 10:24:12,Depositing savings,-1.95,0.00,GBP,COMPLETED,2945.45
TRANSFER,Current,2022-11-14 12:27:27,2022-11-14 12:27:27,Depositing savings,-0.78,0.00,GBP,COMPLETED,2944.67
TRANSFER,Current,2022-11-15 06:06:11,2022-11-15 06:06:12,Depositing savings,-5.00,0.00,GBP,COMPLETED,2939.67
TRANSFER,Current,2022-11-15 08:46:25,2022-11-15 08:46:25,Depositing savings,-2.10,0.00,GBP,COMPLETED,2937.57
CARD_PAYMENT,Current,2022-11-14 12:27:27,2022-11-15 09:40:26,News On The Wharf,-54.74,0.00,GBP,COMPLETED,2882.83
TRANSFER,Current,2022-11-15 10:14:11,2022-11-15 10:14:11,Depositing savings,-0.93,0.00,GBP,COMPLETED,2881.90
TRANSFER,Current,2022-11-15 10:16:40,2022-11-15 10:16:40,Depositing savings,-0.30,0.00,GBP,COMPLETED,2881.60
TRANSFER,Current,2022-11-15 11:17:53,2022-11-15 11:17:53,Depositing savings,-1.20,0.00,GBP,COMPLETED,2880.40
CARD_PAYMENT,Current,2022-11-14 10:24:11,2022-11-15 13:54:34,Starbucks,-3.35,0.00,GBP,COMPLETED,2877.05
TRANSFER,Current,2022-11-15 22:59:30,2022-11-15 22:59:30,Depositing savings,-3.00,0.00,GBP,COMPLETED,2874.05
TRANSFER,Current,2022-11-16 01:18:45,2022-11-16 01:18:45,Depositing savings,-1.80,0.00,GBP,COMPLETED,2872.25
TRANSFER,Current,2022-11-16 06:05:42,2022-11-16 06:05:42,Depositing savings,-5.00,0.00,GBP,COMPLETED,2867.25
TRANSFER,Current,2022-11-16 09:09:56,2022-11-16 09:09:57,Depositing savings,-2.10,0.00,GBP,COMPLETED,2865.15
CARD_PAYMENT,Current,2022-11-15 10:14:10,2022-11-16 09:33:01,News On The Wharf,-5.69,0.00,GBP,COMPLETED,2859.46
TRANSFER,Current,2022-11-16 11:36:13,2022-11-16 11:36:14,Depositing savings,-2.85,0.00,GBP,COMPLETED,2856.61
CARD_PAYMENT,Current,2022-11-15 22:59:29,2022-11-16 11:42:29,EE,-27.00,0.00,GBP,COMPLETED,2829.61
CARD_PAYMENT,Current,2022-11-15 08:46:25,2022-11-16 12:06:38,Starbucks,-3.30,0.00,GBP,COMPLETED,2826.31
CARD_PAYMENT,Current,2022-11-16 01:18:45,2022-11-16 14:52:32,Transport for London,-3.40,0.00,GBP,COMPLETED,2822.91
TRANSFER,Current,2022-11-17 01:18:40,2022-11-17 01:18:40,Depositing savings,-1.20,0.00,GBP,COMPLETED,2821.71
TRANSFER,Current,2022-11-17 06:06:49,2022-11-17 06:06:49,Depositing savings,-5.00,0.00,GBP,COMPLETED,2816.71
TRANSFER,Current,2022-11-17 09:25:46,2022-11-17 09:25:51,Depositing savings,-1.95,0.00,GBP,COMPLETED,2814.76
TRANSFER,Current,2022-11-17 09:26:58,2022-11-17 09:26:58,Depositing savings,-0.60,0.00,GBP,COMPLETED,2814.16
CARD_PAYMENT,Current,2022-11-15 11:17:52,2022-11-17 09:49:33,Pret,-8.60,0.00,GBP,COMPLETED,2805.56
CARD_PAYMENT,Current,2022-11-15 10:16:40,2022-11-17 09:49:33,Pret,-2.90,0.00,GBP,COMPLETED,2802.66
TRANSFER,Current,2022-11-17 12:21:14,2022-11-17 12:21:20,Depositing savings,-2.70,0.00,GBP,COMPLETED,2799.96
CARD_PAYMENT,Current,2022-11-16 09:09:56,2022-11-17 12:48:31,Starbucks,-3.30,0.00,GBP,COMPLETED,2796.66
CARD_PAYMENT,Current,2022-11-17 01:18:39,2022-11-17 14:33:28,Transport for London,-3.60,0.00,GBP,COMPLETED,2793.06
TRANSFER,Current,2022-11-17 19:02:15,2022-11-17 19:02:16,Depositing savings,-3.00,0.00,GBP,COMPLETED,2790.06
TRANSFER,Current,2022-11-17 19:04:51,2022-11-17 19:04:51,From Artem Aleshkin,1058.00,0.00,GBP,COMPLETED,3848.06
TRANSFER,Current,2022-11-18 01:21:21,2022-11-18 01:21:21,Depositing savings,-1.20,0.00,GBP,COMPLETED,3846.86
TRANSFER,Current,2022-11-18 06:09:23,2022-11-18 06:09:23,Depositing savings,-5.00,0.00,GBP,COMPLETED,3841.86
TRANSFER,Current,2022-11-18 08:57:50,2022-11-18 08:57:51,Depositing savings,-2.10,0.00,GBP,COMPLETED,3839.76
TRANSFER,Current,2022-11-18 10:55:36,2022-11-18 10:55:36,Depositing savings,-1.95,0.00,GBP,COMPLETED,3837.81
CARD_PAYMENT,Current,2022-11-17 12:21:14,2022-11-18 12:26:26,Shake Shack,-19.10,0.00,GBP,COMPLETED,3818.71
TRANSFER,Current,2022-11-18 12:37:54,2022-11-18 12:38:10,Depositing savings,-0.78,0.00,GBP,COMPLETED,3817.93
CARD_PAYMENT,Current,2022-11-16 11:36:13,2022-11-18 12:46:24,Marugame Udon,-14.05,0.00,GBP,COMPLETED,3803.88
CARD_PAYMENT,Current,2022-11-18 01:21:21,2022-11-18 14:00:01,Transport for London,-3.60,0.00,GBP,COMPLETED,3800.28
TRANSFER,Current,2022-11-18 17:49:48,2022-11-18 17:49:49,Depositing savings,-2.40,0.00,GBP,COMPLETED,3797.88
TRANSFER,Current,2022-11-18 18:04:27,2022-11-18 18:04:43,Depositing savings,-2.40,0.00,GBP,COMPLETED,3795.48
CARD_PAYMENT,Current,2022-11-17 19:02:15,2022-11-18 18:52:37,norrona.com,-1058.00,0.00,GBP,COMPLETED,2737.48
TRANSFER,Current,2022-11-18 23:11:21,2022-11-18 23:11:21,Depositing savings,-3.00,0.00,GBP,COMPLETED,2734.48
TRANSFER,Current,2022-11-19 01:17:03,2022-11-19 01:17:03,Depositing savings,-1.20,0.00,GBP,COMPLETED,2733.28
TRANSFER,Current,2022-11-19 06:05:46,2022-11-19 06:05:46,Depositing savings,-5.00,0.00,GBP,COMPLETED,2728.28
CARD_PAYMENT,Current,2022-11-18 12:37:25,2022-11-19 09:23:45,News On The Wharf,-54.74,0.00,GBP,COMPLETED,2673.54
CARD_PAYMENT,Current,2022-11-18 23:11:21,2022-11-19 10:56:40,EE,-18.00,0.00,GBP,COMPLETED,2655.54
CARD_PAYMENT,Current,2022-11-17 09:25:46,2022-11-19 11:24:19,Starbucks,-3.35,0.00,GBP,COMPLETED,2652.19
CARD_PAYMENT,Current,2022-11-17 09:26:57,2022-11-19 11:24:19,Starbucks,-19.80,0.00,GBP,COMPLETED,2632.39
TRANSFER,Current,2022-11-19 19:35:39,2022-11-19 19:35:39,Depositing savings,-1.50,0.00,GBP,COMPLETED,2630.89
CARD_PAYMENT,Current,2022-11-19 01:17:02,2022-11-19 19:36:09,Transport for London,-3.60,0.00,GBP,COMPLETED,2627.29
TRANSFER,Current,2022-11-20 06:05:55,2022-11-20 06:05:56,Depositing savings,-5.00,0.00,GBP,COMPLETED,2622.29
TRANSFER,Current,2022-11-20 10:44:55,2022-11-20 10:44:56,Depositing savings,-1.50,0.00,GBP,COMPLETED,2620.79
CARD_PAYMENT,Current,2022-11-19 19:35:38,2022-11-20 10:44:59,SPIRITS OF EAST,-46.50,0.00,GBP,COMPLETED,2574.29
CARD_PAYMENT,Current,2022-11-18 08:57:50,2022-11-20 10:48:18,Starbucks,-3.30,0.00,GBP,COMPLETED,2570.99
CARD_PAYMENT,Current,2022-11-18 10:55:35,2022-11-20 10:48:18,Starbucks,-3.35,0.00,GBP,COMPLETED,2567.64
CARD_PAYMENT,Current,2022-11-18 18:04:23,2022-11-20 11:41:47,No 35 Mackenzie Walk,-7.20,0.00,GBP,COMPLETED,2560.44
CARD_PAYMENT,Current,2022-11-18 17:49:44,2022-11-20 11:41:47,No 35 Mackenzie Walk,-7.20,0.00,GBP,COMPLETED,2553.24
TRANSFER,Current,2022-11-20 13:21:03,2022-11-20 13:21:03,Depositing savings,-1.50,0.00,GBP,COMPLETED,2551.74
TRANSFER,Current,2022-11-20 16:03:36,2022-11-20 16:03:37,Depositing savings,-1.50,0.00,GBP,COMPLETED,2550.24
TRANSFER,Current,2022-11-20 17:32:46,2022-11-20 17:32:46,Depositing savings,-0.06,0.00,GBP,COMPLETED,2550.18
TRANSFER,Current,2022-11-21 01:05:46,2022-11-21 01:05:47,Depositing savings,-2.40,0.00,GBP,COMPLETED,2547.78
TRANSFER,Current,2022-11-21 06:32:12,2022-11-21 06:32:13,Depositing savings,-5.00,0.00,GBP,COMPLETED,2542.78
TRANSFER,Current,2022-11-21 07:58:46,2022-11-21 07:58:47,Depositing savings,-3.00,0.00,GBP,COMPLETED,2539.78
CARD_PAYMENT,Current,2022-11-20 10:44:55,2022-11-21 09:38:20,The Royal Foun,-35.50,0.00,GBP,COMPLETED,2504.28
TRANSFER,Current,2022-11-21 10:03:13,2022-11-21 10:03:13,Depositing savings,-2.22,0.00,GBP,COMPLETED,2502.06
CARD_PAYMENT,Current,2022-11-20 13:21:03,2022-11-21 10:10:06,Botany Bay Hotel,-4.50,0.00,GBP,COMPLETED,2497.56
CARD_PAYMENT,Current,2022-11-20 17:32:46,2022-11-21 10:51:38,Snappy Snaps,-39.98,0.00,GBP,COMPLETED,2457.58
CARD_PAYMENT,Current,2022-11-20 16:03:36,2022-11-21 11:24:04,Sainsbury's,-6.50,0.00,GBP,COMPLETED,2451.08
TRANSFER,Current,2022-11-21 11:45:06,2022-11-21 11:45:06,Depositing savings,-1.95,0.00,GBP,COMPLETED,2449.13
CARD_PAYMENT,Current,2022-11-21 01:05:44,2022-11-21 11:47:04,Transport for London,-3.20,0.00,GBP,COMPLETED,2445.93
TRANSFER,Current,2022-11-21 13:49:58,2022-11-21 13:49:59,Depositing savings,-0.75,0.00,GBP,COMPLETED,2445.18
TRANSFER,Current,2022-11-21 19:18:48,2022-11-21 19:18:53,Depositing savings,-1.92,0.00,GBP,COMPLETED,2443.26
TRANSFER,Current,2022-11-22 01:15:33,2022-11-22 01:15:38,Depositing savings,-0.90,0.00,GBP,COMPLETED,2442.36
TRANSFER,Current,2022-11-22 03:17:12,2022-11-22 03:17:15,Depositing savings,-0.03,0.00,GBP,COMPLETED,2442.33
TRANSFER,Current,2022-11-22 06:05:19,2022-11-22 06:05:20,Depositing savings,-5.00,0.00,GBP,COMPLETED,2437.33
CARD_PAYMENT,Current,2022-11-21 10:03:12,2022-11-22 08:58:50,Notes,-34.26,0.00,GBP,COMPLETED,2403.07
CARD_PAYMENT,Current,2022-11-21 19:18:48,2022-11-22 09:01:39,News On The Wharf,-43.36,0.00,GBP,COMPLETED,2359.71
CARD_PAYMENT,Current,2022-11-21 07:58:46,2022-11-22 09:33:04,D I S T R I C,-12.00,0.00,GBP,COMPLETED,2347.71
CARD_PAYMENT,Current,2022-11-21 11:45:02,2022-11-22 10:42:44,Starbucks,-3.35,0.00,GBP,COMPLETED,2344.36
CARD_PAYMENT,Current,2022-11-21 13:49:55,2022-11-22 10:42:44,Starbucks,-1.75,0.00,GBP,COMPLETED,2342.61
TRANSFER,Current,2022-11-22 11:42:50,2022-11-22 11:42:51,Depositing savings,-3.00,0.00,GBP,COMPLETED,2339.61
TRANSFER,Current,2022-11-22 11:47:26,2022-11-22 11:47:27,Depositing savings,-0.75,0.00,GBP,COMPLETED,2338.86
CARD_PAYMENT,Current,2022-11-22 03:17:11,2022-11-22 14:16:03,Apple,-6.99,0.00,GBP,COMPLETED,2331.87
CARD_PAYMENT,Current,2022-11-22 01:13:44,2022-11-22 15:55:37,Transport for London,-7.70,0.00,GBP,COMPLETED,2324.17
TRANSFER,Current,2022-11-22 18:29:12,2022-11-22 18:29:16,Depositing savings,-1.86,0.00,GBP,COMPLETED,2322.31
TRANSFER,Current,2022-11-22 21:03:42,2022-11-22 21:03:42,Depositing savings,-0.03,0.00,GBP,COMPLETED,2322.28
TRANSFER,Current,2022-11-22 21:04:37,2022-11-22 21:04:37,Depositing savings,-0.03,0.00,GBP,COMPLETED,2322.25
TRANSFER,Current,2022-11-22 21:15:08,2022-11-22 21:15:08,Depositing savings,-0.03,0.00,GBP,COMPLETED,2322.22
TRANSFER,Current,2022-11-23 01:19:16,2022-11-23 01:19:16,Depositing savings,-0.90,0.00,GBP,COMPLETED,2321.32
TRANSFER,Current,2022-11-23 06:05:31,2022-11-23 06:05:32,Depositing savings,-5.00,0.00,GBP,COMPLETED,2316.32
CARD_PAYMENT,Current,2022-11-22 18:29:12,2022-11-23 09:39:40,News On The Wharf,-11.38,0.00,GBP,COMPLETED,2304.94
CARD_PAYMENT,Current,2022-11-22 11:42:50,2022-11-23 10:27:24,Adam Grooming Atelier,-30.00,0.00,GBP,COMPLETED,2274.94
CARD_PAYMENT,Current,2022-11-22 11:47:26,2022-11-23 11:09:08,Starbucks,-2.75,0.00,GBP,COMPLETED,2272.19
TRANSFER,Current,2022-11-23 11:47:19,2022-11-23 11:47:20,Depositing savings,-0.15,0.00,GBP,COMPLETED,2272.04
TRANSFER,Current,2022-11-23 11:50:16,2022-11-23 11:50:17,From Artem Aleshkin,58.00,0.00,GBP,COMPLETED,2330.04
CARD_PAYMENT,Current,2022-11-23 01:19:16,2022-11-23 12:03:16,Transport for London,-7.70,0.00,GBP,COMPLETED,2322.34
TRANSFER,Current,2022-11-23 14:57:48,2022-11-23 14:57:49,Depositing savings,-0.30,0.00,GBP,COMPLETED,2322.04
CARD_PAYMENT,Current,2022-11-22 21:15:08,2022-11-23 15:18:06,Apple,-7.99,0.00,GBP,COMPLETED,2314.05
CARD_PAYMENT,Current,2022-11-22 21:03:41,2022-11-23 15:18:06,Apple,-4.99,0.00,GBP,COMPLETED,2309.06
CARD_PAYMENT,Current,2022-11-22 21:04:37,2022-11-23 15:18:06,Apple,-4.99,0.00,GBP,COMPLETED,2304.07
TRANSFER,Current,2022-11-23 17:08:48,2022-11-23 17:08:53,Depositing savings,-1.92,0.00,GBP,COMPLETED,2302.15
TRANSFER,Current,2022-11-24 01:22:23,2022-11-24 01:22:27,Depositing savings,-1.80,0.00,GBP,COMPLETED,2300.35
TRANSFER,Current,2022-11-24 06:06:48,2022-11-24 06:06:48,Depositing savings,-5.00,0.00,GBP,COMPLETED,2295.35
CARD_PAYMENT,Current,2022-11-23 17:08:43,2022-11-24 09:47:36,News On The Wharf,-43.36,0.00,GBP,COMPLETED,2251.99
CARD_PAYMENT,Current,2022-11-23 14:57:45,2022-11-24 09:51:38,Servedup 640east Caf,-2.90,0.00,GBP,COMPLETED,2249.09
CARD_PAYMENT,Current,2022-11-23 11:47:19,2022-11-24 10:13:38,Ryman,-57.95,0.00,GBP,COMPLETED,2191.14
CARD_PAYMENT,Current,2022-11-24 01:22:23,2022-11-24 11:37:26,Transport for London,-3.40,0.00,GBP,COMPLETED,2187.74
TRANSFER,Current,2022-11-25 01:21:06,2022-11-25 01:21:07,Depositing savings,-0.60,0.00,GBP,COMPLETED,2187.14
TRANSFER,Current,2022-11-25 06:09:48,2022-11-25 06:09:48,Depositing savings,-5.00,0.00,GBP,COMPLETED,2182.14
TRANSFER,Current,2022-11-25 10:35:37,2022-11-25 10:36:01,Depositing savings,-2.10,0.00,GBP,COMPLETED,2180.04
TRANSFER,Current,2022-11-25 15:05:48,2022-11-25 15:05:53,Depositing savings,-1.95,0.00,GBP,COMPLETED,2178.09
CARD_PAYMENT,Current,2022-11-25 01:21:06,2022-11-25 16:09:22,Transport for London,-1.80,0.00,GBP,COMPLETED,2176.29
TRANSFER,Current,2022-11-25 17:48:20,2022-11-25 17:48:25,Depositing savings,-0.78,0.00,GBP,COMPLETED,2175.51
TRANSFER,Current,2022-11-26 06:06:15,2022-11-26 06:06:16,Depositing savings,-5.00,0.00,GBP,COMPLETED,2170.51
CARD_PAYMENT,Current,2022-11-25 17:48:15,2022-11-26 10:03:00,News On The Wharf,-54.74,0.00,GBP,COMPLETED,2115.77
CARD_PAYMENT,Current,2022-11-25 10:33:53,2022-11-26 11:19:39,Starbucks,-3.30,0.00,GBP,COMPLETED,2112.47
CARD_PAYMENT,Current,2022-11-25 15:05:43,2022-11-26 15:57:00,name.com,-16.35,0.00,GBP,COMPLETED,2096.12
TRANSFER,Current,2022-11-26 16:32:19,2022-11-26 16:32:23,Depositing savings,-0.33,0.00,GBP,COMPLETED,2095.79
TRANSFER,Current,2022-11-26 17:24:46,2022-11-26 17:24:50,Depositing savings,-0.27,0.00,GBP,COMPLETED,2095.52
TRANSFER,Current,2022-11-26 21:42:20,2022-11-26 21:42:20,Depositing savings,-0.03,0.00,GBP,COMPLETED,2095.49
TRANSFER,Current,2022-11-27 06:06:00,2022-11-27 06:06:04,Depositing savings,-5.00,0.00,GBP,COMPLETED,2090.49
CARD_PAYMENT,Current,2022-11-26 17:24:43,2022-11-27 11:13:30,Waitrose & Partners,-192.91,0.00,GBP,COMPLETED,1897.58
CARD_PAYMENT,Current,2022-11-26 16:32:13,2022-11-27 11:16:15,Texaco,-56.89,0.00,GBP,COMPLETED,1840.69
CARD_PAYMENT,Current,2022-11-26 21:42:20,2022-11-27 14:44:27,Apple,-4.99,0.00,GBP,COMPLETED,1835.70
TRANSFER,Current,2022-11-28 00:00:00,2022-11-28 01:11:32,To Tfl Congestn Chrge,-75.00,0.00,GBP,COMPLETED,1760.70
TOPUP,Current,2022-11-28 06:16:38,2022-11-28 06:16:38,Payment from Balabanov M,1800.00,0.00,GBP,COMPLETED,3560.70
TRANSFER,Current,2022-11-28 06:32:57,2022-11-28 06:32:58,Depositing savings,-5.00,0.00,GBP,COMPLETED,3555.70
TRANSFER,Current,2022-11-28 09:28:47,2022-11-28 09:28:52,Depositing savings,-0.75,0.00,GBP,COMPLETED,3554.95
TRANSFER,Current,2022-11-28 13:37:11,2022-11-28 13:37:14,Depositing savings,-1.05,0.00,GBP,COMPLETED,3553.90
TRANSFER,Current,2022-11-28 15:28:20,2022-11-28 15:28:20,Depositing savings,-3.00,0.00,GBP,COMPLETED,3550.90
TRANSFER,Current,2022-11-28 18:34:46,2022-11-28 18:34:50,Depositing savings,-0.60,0.00,GBP,COMPLETED,3550.30
TRANSFER,Current,2022-11-28 22:01:28,2022-11-28 22:01:28,Depositing savings,-3.00,0.00,GBP,COMPLETED,3547.30
FEE,Current,2022-11-29 00:30:46,2022-11-29 00:30:46,Metal plan fee,-12.99,0.00,GBP,COMPLETED,3534.31
TRANSFER,Current,2022-11-29 01:18:31,2022-11-29 01:18:31,Depositing savings,-0.60,0.00,GBP,COMPLETED,3533.71
TRANSFER,Current,2022-11-29 06:05:37,,Depositing savings,-5.00,0.00,GBP,REVERTED,
CARD_PAYMENT,Current,2022-11-28 22:01:27,2022-11-29 09:47:30,Zipcar,-26.00,0.00,GBP,COMPLETED,3507.71
CARD_PAYMENT,Current,2022-11-28 09:28:42,2022-11-29 10:49:56,Starbucks,-2.75,0.00,GBP,COMPLETED,3504.96
CARD_PAYMENT,Current,2022-11-28 15:28:20,2022-11-29 11:19:30,Flowers And Plants,-50.00,0.00,GBP,COMPLETED,3454.96
TRANSFER,Current,2022-11-29 13:09:52,,Depositing savings,-0.03,0.00,GBP,REVERTED,
TRANSFER,Current,2022-11-29 13:29:45,2022-11-29 13:29:48,Depositing savings,-0.60,0.00,GBP,COMPLETED,3454.36
TRANSFER,Current,2022-11-29 14:58:19,2022-11-29 14:58:26,Depositing savings,-1.80,0.00,GBP,COMPLETED,3452.56
CARD_PAYMENT,Current,2022-11-28 18:34:46,2022-11-29 15:57:08,Sainsbury's,-0.80,0.00,GBP,COMPLETED,3451.76
CARD_PAYMENT,Current,2022-11-28 13:37:06,2022-11-29 15:58:54,Scribbler,-2.65,0.00,GBP,COMPLETED,3449.11
CARD_PAYMENT,Current,2022-11-29 01:18:31,2022-11-29 16:04:37,Transport for London,-1.80,0.00,GBP,COMPLETED,3447.31
TRANSFER,Current,2022-11-30 00:00:00,2022-11-30 01:02:20,To Virgin Active,-147.00,0.00,GBP,COMPLETED,3300.31
TRANSFER,Current,2022-11-30 04:09:22,2022-11-30 04:09:22,Depositing savings,-0.03,0.00,GBP,COMPLETED,3300.28
TRANSFER,Current,2022-11-30 06:07:37,2022-11-30 06:07:37,Depositing savings,-5.00,0.00,GBP,COMPLETED,3295.28
TRANSFER,Current,2022-11-30 08:02:04,2022-11-30 08:02:07,To Holly Michael,-2450.00,0.00,GBP,COMPLETED,845.28
CARD_PAYMENT,Current,2022-11-29 14:58:15,2022-11-30 09:01:51,Servedup 640east Caf,-2.40,0.00,GBP,COMPLETED,842.88
CARD_PAYMENT,Current,2022-11-29 13:09:48,2022-11-30 09:18:44,Amazon Prime,-8.99,0.00,GBP,COMPLETED,833.89
TRANSFER,Current,2022-11-30 09:25:53,2022-11-30 09:25:57,Depositing savings,-2.25,0.00,GBP,COMPLETED,831.64
CARD_PAYMENT,Current,2022-11-29 13:29:42,2022-11-30 10:42:39,Marugame Udon,-15.80,0.00,GBP,COMPLETED,815.84
CARD_PAYMENT,Current,2022-11-30 04:09:22,2022-11-30 11:01:52,Netflix,-10.99,0.00,GBP,COMPLETED,804.85
TRANSFER,Current,2022-11-30 13:14:19,2022-11-30 13:14:25,Depositing savings,-3.00,0.00,GBP,COMPLETED,801.85
TRANSFER,Current,2022-11-30 13:35:42,2022-11-30 13:35:45,Depositing savings,-3.00,0.00,GBP,COMPLETED,798.85
TRANSFER,Current,2022-11-30 17:51:44,2022-11-30 17:51:45,Depositing savings,-3.00,0.00,GBP,COMPLETED,795.85
TRANSFER,Current,2022-11-30 20:15:15,2022-11-30 20:15:19,Depositing savings,-3.00,0.00,GBP,COMPLETED,792.85
TRANSFER,Current,2022-11-30 20:41:28,2022-11-30 20:41:28,Depositing savings,-3.00,0.00,GBP,COMPLETED,789.85
TRANSFER,Current,2022-11-30 20:44:27,2022-11-30 20:44:32,Withdrawing savings,415.00,0.00,GBP,COMPLETED,1204.85
TRANSFER,Current,2022-11-30 21:23:24,2022-11-30 21:23:24,Depositing savings,-3.00,0.00,GBP,COMPLETED,1201.85
TRANSFER,Current,2022-11-30 22:12:43,2022-11-30 22:12:43,Depositing savings,-0.45,0.00,GBP,COMPLETED,1201.40
TRANSFER,Current,2022-12-01 01:17:25,2022-12-01 01:17:30,Depositing savings,-3.00,0.00,GBP,COMPLETED,1198.40
TRANSFER,Current,2022-12-01 06:13:10,2022-12-01 06:13:10,Depositing savings,-5.00,0.00,GBP,COMPLETED,1193.40
CARD_PAYMENT,Current,2022-11-30 17:51:44,2022-12-01 08:59:32,Riverside Supermarket,-22.00,0.00,GBP,COMPLETED,1171.40
CARD_PAYMENT,Current,2022-11-30 13:14:19,2022-12-01 09:22:00,Wahaca,-10.00,0.00,GBP,COMPLETED,1161.40
CARD_PAYMENT,Current,2022-11-30 09:25:13,2022-12-01 10:25:29,Starbucks,-4.25,0.00,GBP,COMPLETED,1157.15
CARD_PAYMENT,Current,2022-11-30 22:12:42,2022-12-01 10:48:49,Five Guys,-10.85,0.00,GBP,COMPLETED,1146.30
CARD_PAYMENT,Current,2022-11-30 20:15:15,2022-12-01 10:52:32,Vagabond,-5.00,0.00,GBP,COMPLETED,1141.30
CARD_PAYMENT,Current,2022-11-30 21:23:24,2022-12-01 10:52:32,Vagabond,-5.00,0.00,GBP,COMPLETED,1136.30
CARD_PAYMENT,Current,2022-11-30 20:41:27,2022-12-01 10:52:32,Vagabond,-5.00,0.00,GBP,COMPLETED,1131.30
TRANSFER,Current,2022-12-01 12:05:09,2022-12-01 12:05:15,Depositing savings,-1.80,0.00,GBP,COMPLETED,1129.50
CARD_PAYMENT,Current,2022-11-30 13:35:37,2022-12-01 12:52:49,Level39,-2.00,0.00,GBP,COMPLETED,1127.50
CARD_PAYMENT,Current,2022-12-01 01:17:25,2022-12-01 13:01:44,Transport for London,-7.00,0.00,GBP,COMPLETED,1120.50
TRANSFER,Current,2022-12-01 13:10:49,2022-12-01 13:10:55,Depositing savings,-3.00,0.00,GBP,COMPLETED,1117.50
TRANSFER,Current,2022-12-01 16:04:03,2022-12-01 16:04:03,Withdrawing savings,2000.00,0.00,GBP,COMPLETED,3117.50
EXCHANGE,Current,2022-12-01 16:04:35,2022-12-01 16:04:35,Exchanged to EUR,-2000.00,0.00,GBP,COMPLETED,1117.50
TRANSFER,Current,2022-12-01 18:50:59,2022-12-01 18:51:03,Depositing savings,-0.90,0.00,GBP,COMPLETED,1116.60
TRANSFER,Current,2022-12-01 18:54:13,2022-12-01 18:54:18,Depositing savings,-2.40,0.00,GBP,COMPLETED,1114.20
TRANSFER,Current,2022-12-01 20:58:43,2022-12-01 20:58:46,Depositing savings,-0.03,0.00,GBP,COMPLETED,1114.17
TRANSFER,Current,2022-12-01 20:59:05,2022-12-01 20:59:10,Depositing savings,-0.03,0.00,GBP,COMPLETED,1114.14
TRANSFER,Current,2022-12-02 01:20:30,2022-12-02 01:20:31,Depositing savings,-1.80,0.00,GBP,COMPLETED,1112.34
TRANSFER,Current,2022-12-02 06:10:04,2022-12-02 06:10:04,Depositing savings,-5.00,0.00,GBP,COMPLETED,1107.34
TRANSFER,Current,2022-12-02 08:01:55,2022-12-02 08:01:55,To ALEKSANDRA BALABANOVA,-600.00,0.00,GBP,COMPLETED,507.34
CARD_PAYMENT,Current,2022-12-01 13:10:49,2022-12-02 09:51:40,Wahaca,-10.00,0.00,GBP,COMPLETED,497.34
CARD_PAYMENT,Current,2022-12-01 18:54:09,2022-12-02 10:27:44,SPIRITS OF EAST,-4.20,0.00,GBP,COMPLETED,493.14
CARD_PAYMENT,Current,2022-12-01 12:05:08,2022-12-02 11:30:57,Pret,-2.40,0.00,GBP,COMPLETED,490.74
TRANSFER,Current,2022-12-02 14:19:56,2022-12-02 14:19:59,Depositing savings,-3.00,0.00,GBP,COMPLETED,487.74
CARD_PAYMENT,Current,2022-12-01 20:58:42,2022-12-02 15:35:50,Apple,-4.99,0.00,GBP,COMPLETED,482.75
CARD_PAYMENT,Current,2022-12-01 20:59:05,2022-12-02 15:35:52,Apple,-4.99,0.00,GBP,COMPLETED,477.76
TRANSFER,Current,2022-12-02 16:16:29,2022-12-02 16:16:30,Depositing savings,-0.03,0.00,GBP,COMPLETED,477.73
CARD_PAYMENT,Current,2022-12-01 18:50:59,2022-12-02 16:35:02,Sainsbury's,-15.70,0.00,GBP,COMPLETED,462.03
TRANSFER,Current,2022-12-02 16:39:08,2022-12-02 16:39:14,Depositing savings,-3.00,0.00,GBP,COMPLETED,459.03
CARD_PAYMENT,Current,2022-12-02 01:20:30,2022-12-02 17:03:49,Transport for London,-3.40,0.00,GBP,COMPLETED,455.63
TRANSFER,Current,2022-12-03 01:18:01,2022-12-03 01:18:01,Depositing savings,-0.90,0.00,GBP,COMPLETED,454.73
TRANSFER,Current,2022-12-03 06:06:25,2022-12-03 06:06:25,Depositing savings,-5.00,0.00,GBP,COMPLETED,449.73
CARD_PAYMENT,Current,2022-12-02 14:19:51,2022-12-03 09:51:09,The Breakfast Club,-18.00,0.00,GBP,COMPLETED,431.73
TOPUP,Current,2022-12-03 10:21:50,2022-12-03 10:21:50,Payment from Balabanov M,1000.00,0.00,GBP,COMPLETED,1431.73
CARD_PAYMENT,Current,2022-12-02 16:39:07,2022-12-03 10:54:14,JustGiving,-105.00,0.00,GBP,COMPLETED,1326.73
TRANSFER,Current,2022-12-03 15:41:30,2022-12-03 15:41:35,Depositing savings,-0.60,0.00,GBP,COMPLETED,1326.13
CARD_PAYMENT,Current,2022-12-02 16:16:21,2022-12-03 16:52:53,Scribbler,-2.99,0.00,GBP,COMPLETED,1323.14
CARD_PAYMENT,Current,2022-12-03 01:18:01,2022-12-03 17:12:04,Transport for London,-7.70,0.00,GBP,COMPLETED,1315.44
TRANSFER,Current,2022-12-04 06:05:55,2022-12-04 06:05:56,Depositing savings,-5.00,0.00,GBP,COMPLETED,1310.44
CARD_PAYMENT,Current,2022-12-03 15:41:24,2022-12-04 10:42:52,Canary Wharf,-4.80,0.00,GBP,COMPLETED,1305.64
TRANSFER,Current,2022-12-05 06:33:05,2022-12-05 06:33:06,Depositing savings,-5.00,0.00,GBP,COMPLETED,1300.64
TRANSFER,Current,2022-12-05 09:23:42,2022-12-05 09:23:46,Depositing savings,-1.20,0.00,GBP,COMPLETED,1299.44
TRANSFER,Current,2022-12-05 09:42:03,2022-12-05 09:42:14,Depositing savings,-2.10,0.00,GBP,COMPLETED,1297.34
TRANSFER,Current,2022-12-05 11:11:32,2022-12-05 11:11:35,Depositing savings,-1.95,0.00,GBP,COMPLETED,1295.39
TRANSFER,Current,2022-12-05 13:32:44,2022-12-05 13:32:48,Depositing savings,-0.90,0.00,GBP,COMPLETED,1294.49
TRANSFER,Current,2022-12-05 22:45:13,2022-12-05 22:45:13,Depositing savings,-3.00,0.00,GBP,COMPLETED,1291.49
TRANSFER,Current,2022-12-06 06:05:34,2022-12-06 06:05:34,Depositing savings,-5.00,0.00,GBP,COMPLETED,1286.49
CARD_PAYMENT,Current,2022-12-05 09:23:37,2022-12-06 08:48:27,Riverside Supermarket,-51.60,0.00,GBP,COMPLETED,1234.89
TRANSFER,Current,2022-12-06 09:13:50,2022-12-06 09:13:53,Depositing savings,-1.95,0.00,GBP,COMPLETED,1232.94
CARD_PAYMENT,Current,2022-12-05 11:11:28,2022-12-06 10:18:36,Starbucks,-3.35,0.00,GBP,COMPLETED,1229.59
CARD_PAYMENT,Current,2022-12-05 09:41:58,2022-12-06 10:18:36,Starbucks,-3.30,0.00,GBP,COMPLETED,1226.29
TRANSFER,Current,2022-12-06 10:22:54,2022-12-06 10:22:58,Depositing savings,-2.61,0.00,GBP,COMPLETED,1223.68
CARD_PAYMENT,Current,2022-12-05 22:45:13,2022-12-06 10:30:38,EE,-25.00,0.00,GBP,COMPLETED,1198.68
CARD_PAYMENT,Current,2022-12-05 13:32:43,2022-12-06 10:45:52,Marugame Udon,-15.70,0.00,GBP,COMPLETED,1182.98
TRANSFER,Current,2022-12-06 11:39:59,2022-12-06 11:40:01,Depositing savings,-0.03,0.00,GBP,COMPLETED,1182.95
TRANSFER,Current,2022-12-06 13:15:28,2022-12-06 13:25:28,Depositing savings,-3.00,0.00,GBP,COMPLETED,1179.95
TRANSFER,Current,2022-12-06 18:19:07,2022-12-06 18:19:11,Depositing savings,-1.92,0.00,GBP,COMPLETED,1178.03
TRANSFER,Current,2022-12-07 06:05:46,2022-12-07 06:05:46,Depositing savings,-5.00,0.00,GBP,COMPLETED,1173.03
TRANSFER,Current,2022-12-07 08:50:22,2022-12-07 08:50:23,Depositing savings,-3.00,0.00,GBP,COMPLETED,1170.03
CARD_PAYMENT,Current,2022-12-06 13:15:22,2022-12-07 09:01:54,Wahaca,-10.00,0.00,GBP,COMPLETED,1160.03
CARD_PAYMENT,Current,2022-12-06 18:18:56,2022-12-07 09:09:09,News On The Wharf,-43.36,0.00,GBP,COMPLETED,1116.67
CARD_PAYMENT,Current,2022-12-06 09:13:45,2022-12-07 10:09:36,Starbucks,-3.35,0.00,GBP,COMPLETED,1113.32
CARD_PAYMENT,Current,2022-12-06 10:22:50,2022-12-07 13:16:48,Etsy,-27.13,0.00,GBP,COMPLETED,1086.19
CARD_PAYMENT,Current,2022-12-06 11:39:54,2022-12-07 13:17:32,Apple,-16.99,0.00,GBP,COMPLETED,1069.20
TRANSFER,Current,2022-12-08 01:19:46,2022-12-08 01:19:47,Depositing savings,-1.20,0.00,GBP,COMPLETED,1068.00
TRANSFER,Current,2022-12-08 06:07:01,2022-12-08 06:07:01,Depositing savings,-5.00,0.00,GBP,COMPLETED,1063.00
CARD_PAYMENT,Current,2022-12-07 08:50:22,2022-12-08 10:02:43,Starbucks,-2.00,0.00,GBP,COMPLETED,1061.00
TRANSFER,Current,2022-12-08 10:55:55,2022-12-08 10:57:29,Depositing savings,-0.03,0.00,GBP,COMPLETED,1060.97
TRANSFER,Current,2022-12-08 12:35:49,2022-12-08 12:35:49,To MANSUR KURMAKAEV,-17.63,0.00,GBP,COMPLETED,1043.34
CARD_PAYMENT,Current,2022-12-08 01:19:46,2022-12-08 14:25:31,Transport for London,-3.60,0.00,GBP,COMPLETED,1039.74
TRANSFER,Current,2022-12-08 15:09:28,2022-12-08 15:09:28,Depositing savings,-1.74,0.00,GBP,COMPLETED,1038.00
TRANSFER,Current,2022-12-08 16:40:01,2022-12-08 16:40:06,Depositing savings,-2.34,0.00,GBP,COMPLETED,1035.66
TRANSFER,Current,2022-12-09 06:09:19,2022-12-09 06:09:19,Depositing savings,-5.00,0.00,GBP,COMPLETED,1030.66
CARD_PAYMENT,Current,2022-12-08 15:09:23,2022-12-09 09:18:38,News On The Wharf,-76.42,0.00,GBP,COMPLETED,954.24
CARD_PAYMENT,Current,2022-12-08 16:40:01,2022-12-09 10:31:18,Tortilla,-55.22,0.00,GBP,COMPLETED,899.02
TRANSFER,Current,2022-12-09 11:21:49,2022-12-09 11:21:53,Depositing savings,-1.95,0.00,GBP,COMPLETED,897.07
CARD_PAYMENT,Current,2022-12-08 10:55:55,2022-12-09 13:29:41,Apple,-5.99,0.00,GBP,COMPLETED,891.08
TRANSFER,Current,2022-12-10 01:16:46,2022-12-10 01:16:47,Depositing savings,-1.20,0.00,GBP,COMPLETED,889.88
TRANSFER,Current,2022-12-10 06:06:58,2022-12-10 06:06:58,Depositing savings,-5.00,0.00,GBP,COMPLETED,884.88
CARD_PAYMENT,Current,2022-12-09 11:21:45,2022-12-10 10:45:26,Starbucks,-3.35,0.00,GBP,COMPLETED,881.53
TRANSFER,Current,2022-12-10 12:32:58,2022-12-10 12:32:59,Depositing savings,-1.50,0.00,GBP,COMPLETED,880.03
TRANSFER,Current,2022-12-10 13:10:14,2022-12-10 13:10:14,Depositing savings,-0.75,0.00,GBP,COMPLETED,879.28
CARD_PAYMENT,Current,2022-12-10 01:16:46,2022-12-10 15:50:07,Transport for London,-1.60,0.00,GBP,COMPLETED,877.68
TRANSFER,Current,2022-12-10 17:59:34,2022-12-10 18:01:34,Depositing savings,-0.45,0.00,GBP,COMPLETED,877.23
TRANSFER,Current,2022-12-10 19:23:40,2022-12-10 19:29:49,Depositing savings,-0.45,0.00,GBP,COMPLETED,876.78
TRANSFER,Current,2022-12-11 06:05:52,2022-12-11 06:05:53,Depositing savings,-5.00,0.00,GBP,COMPLETED,871.78
CARD_PAYMENT,Current,2022-12-10 12:32:58,2022-12-11 10:16:44,British Heart Foundation,-3.50,0.00,GBP,COMPLETED,868.28
CARD_PAYMENT,Current,2022-12-10 17:57:45,2022-12-11 11:26:36,Sainsbury's,-40.85,0.00,GBP,COMPLETED,827.43
TRANSFER,Current,2022-12-11 12:08:37,2022-12-11 12:08:38,Depositing savings,-0.03,0.00,GBP,COMPLETED,827.40
CARD_PAYMENT,Current,2022-12-10 13:10:13,2022-12-11 15:09:03,IKEA,-11.75,0.00,GBP,COMPLETED,815.65
TRANSFER,Current,2022-12-12 00:00:00,2022-12-12 01:12:34,To Billing Better,-182.82,0.00,GBP,COMPLETED,632.83
TRANSFER,Current,2022-12-12 06:32:13,2022-12-12 06:32:25,Depositing savings,-5.00,0.00,GBP,COMPLETED,627.83
TRANSFER,Current,2022-12-12 10:17:06,2022-12-12 10:17:11,Depositing savings,-1.20,0.00,GBP,COMPLETED,626.63
TRANSFER,Current,2022-12-12 10:58:44,2022-12-12 10:59:03,Depositing savings,-1.95,0.00,GBP,COMPLETED,624.68
CARD_PAYMENT,Current,2022-12-11 12:08:37,2022-12-12 13:23:33,Apple,-6.99,0.00,GBP,COMPLETED,617.69
EXCHANGE,Current,2022-12-12 14:49:38,2022-12-12 14:49:38,Exchanged to GBP,361287.32,0.00,GBP,COMPLETED,361905.01
TRANSFER,Current,2022-12-12 14:50:06,2022-12-12 14:50:06,To GBP Home,-360000.00,0.00,GBP,COMPLETED,1905.01
TRANSFER,Current,2022-12-13 01:10:37,2022-12-13 01:10:37,Depositing savings,-0.60,0.00,GBP,COMPLETED,1904.41
TRANSFER,Current,2022-12-13 06:05:18,2022-12-13 06:05:18,Depositing savings,-5.00,0.00,GBP,COMPLETED,1899.41
CARD_PAYMENT,Current,2022-12-12 10:15:26,2022-12-13 09:20:57,Riverside Supermarket,-51.60,0.00,GBP,COMPLETED,1847.81
CARD_PAYMENT,Current,2022-12-12 10:58:19,2022-12-13 10:13:23,Starbucks,-3.35,0.00,GBP,COMPLETED,1844.46
TRANSFER,Current,2022-12-13 10:30:30,2022-12-13 10:30:30,Depositing savings,-1.95,0.00,GBP,COMPLETED,1842.51
CARD_PAYMENT,Current,2022-12-13 01:10:37,2022-12-13 12:02:59,Transport for London,-1.80,0.00,GBP,COMPLETED,1840.71
TRANSFER,Current,2022-12-13 12:08:53,2022-12-13 12:08:53,Depositing savings,-0.03,0.00,GBP,COMPLETED,1840.68
TRANSFER,Current,2022-12-14 01:10:13,2022-12-14 01:10:13,Depositing savings,-0.60,0.00,GBP,COMPLETED,1840.08
TRANSFER,Current,2022-12-14 06:05:31,2022-12-14 06:05:31,Depositing savings,-5.00,0.00,GBP,COMPLETED,1835.08
TRANSFER,Current,2022-12-14 09:35:08,2022-12-14 09:35:09,Depositing savings,-1.95,0.00,GBP,COMPLETED,1833.13
CARD_PAYMENT,Current,2022-12-13 10:30:24,2022-12-14 10:26:41,Starbucks,-3.35,0.00,GBP,COMPLETED,1829.78
CARD_PAYMENT,Current,2022-12-14 01:10:13,2022-12-14 10:58:52,Transport for London,-1.80,0.00,GBP,COMPLETED,1827.98
CARD_PAYMENT,Current,2022-12-13 12:08:52,2022-12-14 12:43:14,Apple,-5.99,0.00,GBP,COMPLETED,1821.99
TRANSFER,Current,2022-12-14 17:29:45,2022-12-14 17:29:45,Depositing savings,-0.78,0.00,GBP,COMPLETED,1821.21
TRANSFER,Current,2022-12-15 01:10:41,2022-12-15 01:10:41,Depositing savings,-1.20,0.00,GBP,COMPLETED,1820.01
TRANSFER,Current,2022-12-15 06:07:39,2022-12-15 06:07:39,Depositing savings,-5.00,0.00,GBP,COMPLETED,1815.01
TRANSFER,Current,2022-12-15 09:11:38,2022-12-15 09:11:38,Depositing savings,-1.95,0.00,GBP,COMPLETED,1813.06
CARD_PAYMENT,Current,2022-12-14 17:29:45,2022-12-15 13:46:15,News On The Wharf,-54.74,0.00,GBP,COMPLETED,1758.32
CARD_PAYMENT,Current,2022-12-14 09:35:08,2022-12-15 14:40:06,Starbucks,-3.35,0.00,GBP,COMPLETED,1754.97
CARD_PAYMENT,Current,2022-12-15 01:10:41,2022-12-15 16:48:58,Transport for London,-3.60,0.00,GBP,COMPLETED,1751.37
TRANSFER,Current,2022-12-15 18:33:20,2022-12-15 18:33:21,Depositing savings,-1.92,0.00,GBP,COMPLETED,1749.45
TRANSFER,Current,2022-12-15 22:57:10,2022-12-15 22:57:10,Depositing savings,-3.00,0.00,GBP,COMPLETED,1746.45
TRANSFER,Current,2022-12-16 01:18:01,2022-12-16 01:18:01,Depositing savings,-1.20,0.00,GBP,COMPLETED,1745.25
TRANSFER,Current,2022-12-16 06:09:28,2022-12-16 06:09:28,Depositing savings,-5.00,0.00,GBP,COMPLETED,1740.25
CARD_PAYMENT,Current,2022-12-15 18:33:19,2022-12-16 09:00:59,News On The Wharf,-43.36,0.00,GBP,COMPLETED,1696.89
TRANSFER,Current,2022-12-16 10:30:07,2022-12-16 10:30:14,Depositing savings,-1.95,0.00,GBP,COMPLETED,1694.94
CARD_PAYMENT,Current,2022-12-15 09:11:38,2022-12-16 10:34:08,Starbucks,-3.35,0.00,GBP,COMPLETED,1691.59
CARD_PAYMENT,Current,2022-12-15 22:57:10,2022-12-16 10:40:31,EE,-27.00,0.00,GBP,COMPLETED,1664.59
CARD_PAYMENT,Current,2022-12-16 01:18:01,2022-12-16 12:28:09,Transport for London,-3.60,0.00,GBP,COMPLETED,1660.99
TRANSFER,Current,2022-12-16 17:37:53,2022-12-16 17:37:55,Depositing savings,-1.92,0.00,GBP,COMPLETED,1659.07
TRANSFER,Current,2022-12-17 01:11:07,2022-12-17 01:11:08,Depositing savings,-1.20,0.00,GBP,COMPLETED,1657.87
TRANSFER,Current,2022-12-17 06:05:52,2022-12-17 06:05:53,Depositing savings,-5.00,0.00,GBP,COMPLETED,1652.87
TRANSFER,Current,2022-12-17 07:26:32,2022-12-17 07:26:32,Depositing savings,-2.40,0.00,GBP,COMPLETED,1650.47
CARD_PAYMENT,Current,2022-12-16 17:37:53,2022-12-17 09:04:32,News On The Wharf,-43.36,0.00,GBP,COMPLETED,1607.11
CARD_PAYMENT,Current,2022-12-16 10:30:07,2022-12-17 10:16:15,Starbucks,-3.35,0.00,GBP,COMPLETED,1603.76
CARD_PAYMENT,Current,2022-12-17 01:11:07,2022-12-17 12:34:05,Transport for London,-1.60,0.00,GBP,COMPLETED,1602.16
TRANSFER,Current,2022-12-17 18:42:59,2022-12-17 18:42:59,Depositing savings,-3.00,0.00,GBP,COMPLETED,1599.16
TRANSFER,Current,2022-12-18 01:10:42,2022-12-18 01:10:42,Depositing savings,-1.20,0.00,GBP,COMPLETED,1597.96
TRANSFER,Current,2022-12-18 06:05:39,2022-12-18 06:05:40,Depositing savings,-5.00,0.00,GBP,COMPLETED,1592.96
CARD_PAYMENT,Current,2022-12-18 01:10:42,2022-12-18 13:58:46,Transport for London,-1.60,0.00,GBP,COMPLETED,1591.36
CARD_PAYMENT,Current,2022-12-17 18:42:58,2022-12-18 14:06:30,Honest Burgers,-31.00,0.00,GBP,COMPLETED,1560.36
TRANSFER,Current,2022-12-18 16:25:45,2022-12-18 16:25:45,Depositing savings,-0.72,0.00,GBP,COMPLETED,1559.64
TRANSFER,Current,2022-12-18 23:11:08,2022-12-18 23:11:08,Depositing savings,-3.00,0.00,GBP,COMPLETED,1556.64
TRANSFER,Current,2022-12-19 06:31:41,2022-12-19 06:31:41,Depositing savings,-5.00,0.00,GBP,COMPLETED,1551.64
TRANSFER,Current,2022-12-19 08:00:34,2022-12-19 08:00:35,Depositing savings,-1.20,0.00,GBP,COMPLETED,1550.44
CARD_PAYMENT,Current,2022-12-17 07:26:32,2022-12-19 08:43:20,Pret,-3.20,0.00,GBP,COMPLETED,1547.24
TRANSFER,Current,2022-12-19 09:07:50,2022-12-19 09:07:50,Depositing savings,-1.95,0.00,GBP,COMPLETED,1545.29
CARD_PAYMENT,Current,2022-12-18 23:11:07,2022-12-19 09:34:22,EE,-18.00,0.00,GBP,COMPLETED,1527.29
CARD_PAYMENT,Current,2022-12-18 16:25:44,2022-12-19 10:29:55,Stoke Newington Green,-31.76,0.00,GBP,COMPLETED,1495.53
TRANSFER,Current,2022-12-20 06:05:35,2022-12-20 06:05:35,Depositing savings,-5.00,0.00,GBP,COMPLETED,1490.53
CARD_PAYMENT,Current,2022-12-19 08:00:34,2022-12-20 08:44:09,Riverside Supermarket,-51.60,0.00,GBP,COMPLETED,1438.93
CARD_PAYMENT,Current,2022-12-19 09:07:48,2022-12-20 10:09:52,Starbucks,-3.35,0.00,GBP,COMPLETED,1435.58
TRANSFER,Current,2022-12-20 10:59:14,2022-12-20 10:59:14,Depositing savings,-3.00,0.00,GBP,COMPLETED,1432.58
TRANSFER,Current,2022-12-20 17:22:58,2022-12-20 17:23:08,Depositing savings,-2.70,0.00,GBP,COMPLETED,1429.88
TRANSFER,Current,2022-12-21 01:13:26,2022-12-21 01:13:26,Depositing savings,-1.80,0.00,GBP,COMPLETED,1428.08
TRANSFER,Current,2022-12-21 06:05:31,2022-12-21 06:05:31,Depositing savings,-5.00,0.00,GBP,COMPLETED,1423.08
CARD_PAYMENT,Current,2022-12-20 10:59:14,2022-12-21 09:43:38,Adam Grooming Atelier,-30.00,0.00,GBP,COMPLETED,1393.08
TRANSFER,Current,2022-12-21 10:09:05,2022-12-21 10:09:05,Depositing savings,-1.95,0.00,GBP,COMPLETED,1391.13
TRANSFER,Current,2022-12-21 10:11:50,2022-12-21 10:11:50,Depositing savings,-0.60,0.00,GBP,COMPLETED,1390.53
TOPUP,Current,2022-12-21 10:18:06,2022-12-21 10:18:06,Payment from Balabanov M,931.52,0.00,GBP,COMPLETED,2322.05
CARD_PAYMENT,Current,2022-12-21 01:13:26,2022-12-21 16:01:25,Transport for London,-3.40,0.00,GBP,COMPLETED,2318.65
TRANSFER,Current,2022-12-22 01:16:27,2022-12-22 01:16:27,Depositing savings,-2.40,0.00,GBP,COMPLETED,2316.25
TRANSFER,Current,2022-12-22 03:17:50,2022-12-22 03:17:50,Depositing savings,-0.03,0.00,GBP,COMPLETED,2316.22
TRANSFER,Current,2022-12-22 06:06:40,2022-12-22 06:06:41,Depositing savings,-5.00,0.00,GBP,COMPLETED,2311.22
CARD_PAYMENT,Current,2022-12-22 01:16:27,2022-12-22 18:34:15,Transport for London,-3.20,0.00,GBP,COMPLETED,2308.02
CARD_PAYMENT,Current,2022-12-22 03:17:49,2022-12-22 19:01:20,Apple,-6.99,0.00,GBP,COMPLETED,2301.03
CARD_PAYMENT,Current,2022-12-20 17:22:57,2022-12-22 20:23:31,No 35 Mackenzie Walk,-7.10,0.00,GBP,COMPLETED,2293.93
TRANSFER,Current,2022-12-23 01:10:43,2022-12-23 01:10:43,Depositing savings,-2.40,0.00,GBP,COMPLETED,2291.53
TRANSFER,Current,2022-12-23 06:09:10,2022-12-23 06:09:11,Depositing savings,-5.00,0.00,GBP,COMPLETED,2286.53
TRANSFER,Current,2022-12-23 09:39:37,2022-12-23 09:39:37,Depositing savings,-3.00,0.00,GBP,COMPLETED,2283.53
CARD_PAYMENT,Current,2022-12-21 10:09:04,2022-12-23 10:30:22,Starbucks,-3.35,0.00,GBP,COMPLETED,2280.18
CARD_PAYMENT,Current,2022-12-21 10:11:38,2022-12-23 10:30:22,Starbucks,-19.80,0.00,GBP,COMPLETED,2260.38
TRANSFER,Current,2022-12-23 10:57:48,2022-12-23 10:58:36,Depositing savings,-3.00,0.00,GBP,COMPLETED,2257.38
TRANSFER,Current,2022-12-23 11:51:46,2022-12-23 11:51:46,Depositing savings,-2.70,0.00,GBP,COMPLETED,2254.68
TRANSFER,Current,2022-12-23 12:44:31,2022-12-23 12:44:31,Depositing savings,-2.25,0.00,GBP,COMPLETED,2252.43
CARD_PAYMENT,Current,2022-12-23 01:10:43,2022-12-23 12:59:45,Transport for London,-7.20,0.00,GBP,COMPLETED,2245.23
TRANSFER,Current,2022-12-23 16:16:08,2022-12-23 16:16:08,Depositing savings,-3.00,0.00,GBP,COMPLETED,2242.23
TRANSFER,Current,2022-12-23 16:21:35,2022-12-23 16:21:36,Depositing savings,-0.60,0.00,GBP,COMPLETED,2241.63
TRANSFER,Current,2022-12-24 06:05:47,2022-12-24 06:05:48,Depositing savings,-5.00,0.00,GBP,COMPLETED,2236.63
CARD_PAYMENT,Current,2022-12-23 16:16:08,2022-12-24 10:18:39,SPIRITS OF EAST,-116.00,0.00,GBP,COMPLETED,2120.63
CARD_PAYMENT,Current,2022-12-23 09:39:36,2022-12-24 11:25:50,RingGo,-6.00,0.00,GBP,COMPLETED,2114.63
CARD_PAYMENT,Current,2022-12-23 10:57:47,2022-12-24 11:25:51,RingGo,-6.00,0.00,GBP,COMPLETED,2108.63
CARD_PAYMENT,Current,2022-12-23 11:51:46,2022-12-24 11:25:51,RingGo,-3.10,0.00,GBP,COMPLETED,2105.53
CARD_PAYMENT,Current,2022-12-23 16:21:35,2022-12-24 15:19:28,Sainsbury's,-11.80,0.00,GBP,COMPLETED,2093.73
TRANSFER,Current,2022-12-24 22:43:20,2022-12-24 22:43:20,Depositing savings,-0.48,0.00,GBP,COMPLETED,2093.25
TRANSFER,Current,2022-12-25 01:01:44,2022-12-25 01:01:44,Depositing savings,-2.40,0.00,GBP,COMPLETED,2090.85
TRANSFER,Current,2022-12-25 06:06:02,2022-12-25 06:06:02,Depositing savings,-5.00,0.00,GBP,COMPLETED,2085.85
CARD_PAYMENT,Current,2022-12-23 12:44:31,2022-12-25 10:56:15,PayByPhone,-6.25,0.00,GBP,COMPLETED,2079.60
CARD_PAYMENT,Current,2022-12-25 01:01:44,2022-12-25 11:07:54,Transport for London,-5.20,0.00,GBP,COMPLETED,2074.40
TRANSFER,Current,2022-12-26 06:32:00,2022-12-26 06:32:00,Depositing savings,-5.00,0.00,GBP,COMPLETED,2069.40
CARD_PAYMENT,Current,2022-12-24 22:43:19,2022-12-26 08:45:02,Uber,-7.84,0.00,GBP,COMPLETED,2061.56
TRANSFER,Current,2022-12-26 15:03:05,2022-12-26 15:03:05,Depositing savings,-0.06,0.00,GBP,COMPLETED,2061.50
TRANSFER,Current,2022-12-26 15:23:33,2022-12-26 15:23:33,Depositing savings,-0.15,0.00,GBP,COMPLETED,2061.35
TRANSFER,Current,2022-12-26 18:37:06,2022-12-26 18:37:07,Depositing savings,-3.00,0.00,GBP,COMPLETED,2058.35
TRANSFER,Current,2022-12-26 21:06:31,2022-12-26 21:06:32,Depositing savings,-0.03,0.00,GBP,COMPLETED,2058.32
TRANSFER,Current,2022-12-27 06:05:35,2022-12-27 06:05:35,Depositing savings,-5.00,0.00,GBP,COMPLETED,2053.32
CARD_PAYMENT,Current,2022-12-26 15:23:33,2022-12-27 08:46:17,TK Maxx,-22.95,0.00,GBP,COMPLETED,2030.37
CARD_PAYMENT,Current,2022-12-26 15:03:05,2022-12-27 08:46:17,TK Maxx,-100.98,0.00,GBP,COMPLETED,1929.39
CARD_PAYMENT,Current,2022-12-26 18:37:06,2022-12-27 09:07:04,The Victoria,-150.00,0.00,GBP,COMPLETED,1779.39
CARD_PAYMENT,Current,2022-12-26 21:06:31,2022-12-27 12:33:46,Apple,-5.99,0.00,GBP,COMPLETED,1773.40
TRANSFER,Current,2022-12-28 06:06:09,2022-12-28 06:06:10,Depositing savings,-5.00,0.00,GBP,COMPLETED,1768.40
TRANSFER,Current,2022-12-28 14:54:20,2022-12-28 14:54:21,Depositing savings,-2.76,0.00,GBP,COMPLETED,1765.64
TRANSFER,Current,2022-12-28 19:21:11,2022-12-28 19:21:12,Depositing savings,-2.16,0.00,GBP,COMPLETED,1763.48
FEE,Current,2022-12-28 23:04:43,2022-12-28 23:04:43,Metal plan fee,-12.99,0.00,GBP,COMPLETED,1750.49
TRANSFER,Current,2022-12-29 01:04:14,2022-12-29 01:04:14,Depositing savings,-1.80,0.00,GBP,COMPLETED,1748.69
TRANSFER,Current,2022-12-29 06:06:57,2022-12-29 06:06:57,Depositing savings,-5.00,0.00,GBP,COMPLETED,1743.69
TRANSFER,Current,2022-12-29 06:51:39,2022-12-29 06:51:39,Withdrawing savings,30191.25,0.00,GBP,COMPLETED,31934.94
TRANSFER,Current,2022-12-29 06:52:21,2022-12-29 06:52:21,To GBP Home,-20000.00,0.00,GBP,COMPLETED,11934.94
TRANSFER,Current,2022-12-29 06:53:49,2022-12-29 06:53:50,Depositing savings,-8000.00,0.00,GBP,COMPLETED,3934.94
CARD_PAYMENT,Current,2022-12-28 14:54:15,2022-12-29 09:50:39,Post Office,-1.08,0.00,GBP,COMPLETED,3933.86
CARD_PAYMENT,Current,2022-12-28 19:21:04,2022-12-29 10:20:32,Uber Eats,-49.28,0.00,GBP,COMPLETED,3884.58
CARD_PAYMENT,Current,2022-12-29 01:04:14,2022-12-29 11:02:21,Transport for London,-3.40,0.00,GBP,COMPLETED,3881.18
TRANSFER,Current,2022-12-29 13:13:07,2022-12-29 13:13:07,Depositing savings,-0.03,0.00,GBP,COMPLETED,3881.15
TRANSFER,Current,2022-12-29 13:46:37,2022-12-29 13:46:37,Depositing savings,-1.29,0.00,GBP,COMPLETED,3879.86
TRANSFER,Current,2022-12-29 15:41:53,2022-12-29 15:41:53,Depositing savings,-2.61,0.00,GBP,COMPLETED,3877.25
TRANSFER,Current,2022-12-29 16:33:01,2022-12-29 16:33:01,Depositing savings,-1.35,0.00,GBP,COMPLETED,3875.90
TRANSFER,Current,2022-12-30 00:00:00,2022-12-30 01:01:01,To Virgin Active,-147.00,0.00,GBP,COMPLETED,3728.90
TRANSFER,Current,2022-12-30 05:19:05,2022-12-30 05:19:05,Depositing savings,-0.03,0.00,GBP,COMPLETED,3728.87
TRANSFER,Current,2022-12-30 06:09:46,2022-12-30 06:09:47,Depositing savings,-5.00,0.00,GBP,COMPLETED,3723.87
TRANSFER,Current,2022-12-30 08:01:54,2022-12-30 08:01:56,To Holly Michael,-2450.00,0.00,GBP,COMPLETED,1273.87
CARD_PAYMENT,Current,2022-12-29 13:13:07,2022-12-30 09:19:42,Amazon Prime,-8.99,0.00,GBP,COMPLETED,1264.88
CARD_PAYMENT,Current,2022-12-29 13:46:37,2022-12-30 10:36:07,Waitrose & Partners,-187.57,0.00,GBP,COMPLETED,1077.31
TRANSFER,Current,2022-12-30 10:36:16,2022-12-30 10:36:16,From WECTORY LTD,2090.42,0.00,GBP,COMPLETED,3167.73
TRANSFER,Current,2022-12-30 16:45:35,2022-12-30 16:45:36,Depositing savings,-0.03,0.00,GBP,COMPLETED,3167.70
TRANSFER,Current,2022-12-30 21:52:57,2022-12-30 21:58:05,To Mikhail Balabanov,-1000.00,0.00,GBP,COMPLETED,2167.70
TRANSFER,Current,2022-12-31 06:06:51,2022-12-31 06:06:52,Depositing savings,-5.00,0.00,GBP,COMPLETED,2162.70
CARD_PAYMENT,Current,2022-12-29 16:33:01,2022-12-31 09:08:43,PayByPhone,-0.55,0.00,GBP,COMPLETED,2162.15
CARD_PAYMENT,Current,2022-12-29 15:41:52,2022-12-31 09:08:51,PayByPhone,-2.13,0.00,GBP,COMPLETED,2160.02
CARD_PAYMENT,Current,2022-12-30 05:19:05,2022-12-31 09:11:22,Netflix,-10.99,0.00,GBP,COMPLETED,2149.03
CARD_PAYMENT,Current,2022-12-30 16:45:35,2022-12-31 10:05:16,Amazon,-25.99,0.00,GBP,COMPLETED,2123.04
TRANSFER,Current,2023-01-01 01:04:49,2023-01-01 01:04:50,Depositing savings,-1.20,0.00,GBP,COMPLETED,2121.84
TRANSFER,Current,2023-01-01 06:11:56,2023-01-01 06:11:56,Depositing savings,-5.00,0.00,GBP,COMPLETED,2116.84
CARD_PAYMENT,Current,2023-01-01 01:04:49,2023-01-01 10:56:08,Transport for London,-2.60,0.00,GBP,COMPLETED,2114.24
TRANSFER,Current,2023-01-02 06:32:22,2023-01-02 06:32:22,Depositing savings,-5.00,0.00,GBP,COMPLETED,2109.24
TRANSFER,Current,2023-01-02 08:01:54,2023-01-02 08:01:54,To ALEKSANDRA BALABANOVA,-600.00,0.00,GBP,COMPLETED,1509.24
TRANSFER,Current,2023-01-02 18:57:40,2023-01-02 18:57:40,Depositing savings,-0.18,0.00,GBP,COMPLETED,1509.06
TRANSFER,Current,2023-01-03 06:05:55,2023-01-03 06:05:55,Depositing savings,-5.00,0.00,GBP,COMPLETED,1504.06
TRANSFER,Current,2023-01-04 01:06:14,2023-01-04 01:06:15,Depositing savings,-1.80,0.00,GBP,COMPLETED,1502.26
TRANSFER,Current,2023-01-04 06:05:48,2023-01-04 06:05:48,Depositing savings,-5.00,0.00,GBP,COMPLETED,1497.26
CARD_PAYMENT,Current,2023-01-02 18:57:39,2023-01-04 09:28:31,Amazon,-54.94,0.00,GBP,COMPLETED,1442.32
CARD_PAYMENT,Current,2023-01-04 01:06:14,2023-01-04 10:37:00,Transport for London,-3.40,0.00,GBP,COMPLETED,1438.92
TRANSFER,Current,2023-01-04 22:53:04,2023-01-04 22:54:52,Depositing savings,-3.00,0.00,GBP,COMPLETED,1435.92
TRANSFER,Current,2023-01-05 01:07:45,2023-01-05 01:08:49,Depositing savings,-2.40,0.00,GBP,COMPLETED,1433.52
TRANSFER,Current,2023-01-05 06:07:45,2023-01-05 06:08:51,Depositing savings,-5.00,0.00,GBP,COMPLETED,1428.52
CARD_PAYMENT,Current,2023-01-04 22:51:59,2023-01-05 10:53:53,EE,-25.00,0.00,GBP,COMPLETED,1403.52
CARD_PAYMENT,Current,2023-01-05 01:07:00,2023-01-05 11:27:41,Transport for London,-3.20,0.00,GBP,COMPLETED,1400.32
TRANSFER,Current,2023-01-05 21:02:58,2023-01-05 21:02:58,Withdrawing savings,330.76,0.00,GBP,COMPLETED,1731.08
TRANSFER,Current,2023-01-05 21:03:21,2023-01-05 21:03:21,To GBP,5.94,0.00,GBP,COMPLETED,1737.02
TRANSFER,Current,2023-01-05 21:04:03,2023-01-05 21:04:04,Withdrawing savings,2000.00,0.00,GBP,COMPLETED,3737.02
TRANSFER,Current,2023-01-05 21:04:16,2023-01-05 21:04:16,Withdrawing savings,89.17,0.00,GBP,COMPLETED,3826.19
TRANSFER,Current,2023-01-05 21:04:53,2023-01-05 21:04:55,To Mikhail Balabanov,-2000.00,0.00,GBP,COMPLETED,1826.19
TRANSFER,Current,2023-01-06 06:09:35,2023-01-06 06:09:36,Depositing savings,-5.00,0.00,GBP,COMPLETED,1821.19
TRANSFER,Current,2023-01-06 11:41:44,2023-01-06 11:41:45,Depositing savings,-0.03,0.00,GBP,COMPLETED,1821.16
TRANSFER,Current,2023-01-07 01:07:39,2023-01-07 01:07:39,Depositing savings,-0.60,0.00,GBP,COMPLETED,1820.56
TRANSFER,Current,2023-01-07 06:06:07,2023-01-07 06:06:08,Depositing savings,-5.00,0.00,GBP,COMPLETED,1815.56
CARD_PAYMENT,Current,2023-01-07 01:07:39,2023-01-07 10:49:55,Transport for London,-1.80,0.00,GBP,COMPLETED,1813.76
CARD_PAYMENT,Current,2023-01-06 11:41:44,2023-01-07 12:08:16,Apple,-16.99,0.00,GBP,COMPLETED,1796.77
TRANSFER,Current,2023-01-08 06:05:54,2023-01-08 06:05:54,Depositing savings,-5.00,0.00,GBP,COMPLETED,1791.77
TRANSFER,Current,2023-01-09 06:31:50,2023-01-09 06:31:51,Depositing savings,-5.00,0.00,GBP,COMPLETED,1786.77
TRANSFER,Current,2023-01-09 17:09:59,2023-01-09 17:10:13,To AMERICAN EXP 3773,-1069.88,0.00,GBP,COMPLETED,716.89
TRANSFER,Current,2023-01-10 01:10:30,2023-01-10 01:10:30,Depositing savings,-1.80,0.00,GBP,COMPLETED,715.09
TRANSFER,Current,2023-01-10 06:06:26,2023-01-10 06:06:27,Depositing savings,-5.00,0.00,GBP,COMPLETED,710.09
CARD_PAYMENT,Current,2023-01-10 01:10:29,2023-01-10 10:44:47,Transport for London,-3.40,0.00,GBP,COMPLETED,706.69
TRANSFER,Current,2023-01-11 01:17:31,2023-01-11 01:17:31,Depositing savings,-2.40,0.00,GBP,COMPLETED,704.29
TRANSFER,Current,2023-01-11 06:05:51,2023-01-11 06:05:51,Depositing savings,-5.00,0.00,GBP,COMPLETED,699.29
CARD_PAYMENT,Current,2023-01-11 01:17:31,2023-01-11 10:32:40,Transport for London,-3.20,0.00,GBP,COMPLETED,696.09
TRANSFER,Current,2023-01-11 12:11:01,2023-01-11 12:11:02,Depositing savings,-0.03,0.00,GBP,COMPLETED,696.06
TRANSFER,Current,2023-01-12 00:00:00,2023-01-12 01:06:18,To Billing Better,-195.51,0.00,GBP,COMPLETED,500.55
TRANSFER,Current,2023-01-12 01:17:21,2023-01-12 01:17:22,Depositing savings,-2.40,0.00,GBP,COMPLETED,498.15
TRANSFER,Current,2023-01-12 06:07:00,2023-01-12 06:07:00,Depositing savings,-5.00,0.00,GBP,COMPLETED,493.15
CARD_PAYMENT,Current,2023-01-12 01:17:21,2023-01-12 11:04:29,Transport for London,-3.20,0.00,GBP,COMPLETED,489.95
CARD_PAYMENT,Current,2023-01-11 12:11:01,2023-01-12 12:43:04,Apple,-6.99,0.00,GBP,COMPLETED,482.96
TRANSFER,Current,2023-01-13 01:13:56,2023-01-13 01:13:56,Depositing savings,-3.00,0.00,GBP,COMPLETED,479.96
TRANSFER,Current,2023-01-13 06:09:34,2023-01-13 06:09:34,Depositing savings,-5.00,0.00,GBP,COMPLETED,474.96
CARD_PAYMENT,Current,2023-01-13 01:13:55,2023-01-13 11:22:42,Transport for London,-7.00,0.00,GBP,COMPLETED,467.96
TRANSFER,Current,2023-01-13 12:10:02,2023-01-13 12:10:04,Depositing savings,-0.03,0.00,GBP,COMPLETED,467.93
TRANSFER,Current,2023-01-14 01:11:59,2023-01-14 01:11:59,Depositing savings,-0.90,0.00,GBP,COMPLETED,467.03
TRANSFER,Current,2023-01-14 06:05:53,2023-01-14 06:05:54,Depositing savings,-5.00,0.00,GBP,COMPLETED,462.03
CARD_PAYMENT,Current,2023-01-13 12:10:02,2023-01-14 13:02:50,Apple,-5.99,0.00,GBP,COMPLETED,456.04
CARD_PAYMENT,Current,2023-01-14 01:11:59,2023-01-14 13:24:12,Transport for London,-7.70,0.00,GBP,COMPLETED,448.34
TRANSFER,Current,2023-01-14 23:01:28,2023-01-14 23:01:29,Depositing savings,-3.00,0.00,GBP,COMPLETED,445.34
TRANSFER,Current,2023-01-15 06:06:35,2023-01-15 06:06:35,Depositing savings,-5.00,0.00,GBP,COMPLETED,440.34
TRANSFER,Current,2023-01-16 06:32:09,2023-01-16 06:32:09,Depositing savings,-5.00,0.00,GBP,COMPLETED,435.34
CARD_PAYMENT,Current,2023-01-14 23:01:28,2023-01-16 09:11:32,EE,-27.00,0.00,GBP,COMPLETED,408.34
TRANSFER,Current,2023-01-17 01:10:27,2023-01-17 01:10:28,Depositing savings,-1.80,0.00,GBP,COMPLETED,406.54
TRANSFER,Current,2023-01-17 06:05:26,2023-01-17 06:05:26,Depositing savings,-5.00,0.00,GBP,COMPLETED,401.54
CARD_PAYMENT,Current,2023-01-17 01:10:27,2023-01-17 10:33:36,Transport for London,-3.40,0.00,GBP,COMPLETED,398.14
TRANSFER,Current,2023-01-17 15:22:05,2023-01-17 15:22:17,From MANSUR KURMAKAEV,910.00,0.00,GBP,COMPLETED,1308.14
TRANSFER,Current,2023-01-17 23:02:36,2023-01-17 23:02:36,Depositing savings,-3.00,0.00,GBP,COMPLETED,1305.14
TRANSFER,Current,2023-01-18 01:13:33,2023-01-18 01:13:34,Depositing savings,-1.80,0.00,GBP,COMPLETED,1303.34
TRANSFER,Current,2023-01-18 06:05:41,2023-01-18 06:05:42,Depositing savings,-5.00,0.00,GBP,COMPLETED,1298.34
CARD_PAYMENT,Current,2023-01-18 01:13:33,2023-01-18 10:53:27,Transport for London,-3.40,0.00,GBP,COMPLETED,1294.94
CARD_PAYMENT,Current,2023-01-17 23:02:36,2023-01-18 11:08:42,EE,-18.00,0.00,GBP,COMPLETED,1276.94
TRANSFER,Current,2023-01-18 22:48:13,2023-01-18 22:48:13,Depositing savings,-1.53,0.00,GBP,COMPLETED,1275.41
TRANSFER,Current,2023-01-18 23:11:21,2023-01-18 23:11:21,Depositing savings,-0.03,0.00,GBP,COMPLETED,1275.38
TRANSFER,Current,2023-01-18 23:11:44,2023-01-18 23:11:44,Depositing savings,-1.53,0.00,GBP,COMPLETED,1273.85
TRANSFER,Current,2023-01-19 01:15:43,2023-01-19 01:15:43,Depositing savings,-1.20,0.00,GBP,COMPLETED,1272.65
TRANSFER,Current,2023-01-19 06:06:47,2023-01-19 06:06:47,Depositing savings,-5.00,0.00,GBP,COMPLETED,1267.65
CARD_PAYMENT,Current,2023-01-18 23:11:20,2023-01-19 14:32:17,Apple,-7.99,0.00,GBP,COMPLETED,1259.66
CARD_PAYMENT,Current,2023-01-18 22:48:12,2023-01-19 14:32:17,Apple,-4.49,0.00,GBP,COMPLETED,1255.17
CARD_PAYMENT,Current,2023-01-19 01:15:43,2023-01-19 15:09:17,Transport for London,-3.60,0.00,GBP,COMPLETED,1251.57
TRANSFER,Current,2023-01-20 01:16:11,2023-01-20 01:16:12,Depositing savings,-1.20,0.00,GBP,COMPLETED,1250.37
TRANSFER,Current,2023-01-20 06:09:55,2023-01-20 06:09:58,Depositing savings,-5.00,0.00,GBP,COMPLETED,1245.37
CARD_PAYMENT,Current,2023-01-20 01:16:11,2023-01-20 10:47:12,Transport for London,-1.60,0.00,GBP,COMPLETED,1243.77
CARD_PAYMENT,Current,2023-01-18 23:11:44,2023-01-20 12:24:09,Apple,-4.49,0.00,GBP,COMPLETED,1239.28
TRANSFER,Current,2023-01-21 01:10:53,2023-01-21 01:10:54,Depositing savings,-1.20,0.00,GBP,COMPLETED,1238.08
TRANSFER,Current,2023-01-21 06:05:57,2023-01-21 06:05:58,Depositing savings,-5.00,0.00,GBP,COMPLETED,1233.08
CARD_PAYMENT,Current,2023-01-21 01:10:53,2023-01-21 11:11:17,Transport for London,-3.60,0.00,GBP,COMPLETED,1229.48
TRANSFER,Current,2023-01-22 03:17:07,2023-01-22 03:17:07,Depositing savings,-0.03,0.00,GBP,COMPLETED,1229.45
TRANSFER,Current,2023-01-22 06:05:43,2023-01-22 06:05:43,Depositing savings,-5.00,0.00,GBP,COMPLETED,1224.45
TRANSFER,Current,2023-01-23 06:32:01,2023-01-23 06:32:01,Depositing savings,-5.00,0.00,GBP,COMPLETED,1219.45
CARD_PAYMENT,Current,2023-01-22 03:17:06,2023-01-23 12:44:55,Apple,-6.99,0.00,GBP,COMPLETED,1212.46
TRANSFER,Current,2023-01-24 06:05:24,2023-01-24 06:05:25,Depositing savings,-5.00,0.00,GBP,COMPLETED,1207.46
TRANSFER,Current,2023-01-25 01:13:03,2023-01-25 01:13:03,Depositing savings,-1.20,0.00,GBP,COMPLETED,1206.26
TRANSFER,Current,2023-01-25 06:06:07,2023-01-25 06:06:08,Depositing savings,-5.00,0.00,GBP,COMPLETED,1201.26
CARD_PAYMENT,Current,2023-01-25 01:13:03,2023-01-25 11:30:48,Transport for London,-1.60,0.00,GBP,COMPLETED,1199.66
TRANSFER,Current,2023-01-25 12:35:22,2023-01-25 12:35:22,Withdrawing savings,2500.00,0.00,GBP,COMPLETED,3699.66
TRANSFER,Current,2023-01-25 12:38:33,2023-01-25 12:38:36,To HMRC Cumbernauld,-2428.40,0.00,GBP,COMPLETED,1271.26
TRANSFER,Current,2023-01-26 00:00:00,2023-01-26 01:04:03,To Tfl Congestn Chrge,-55.00,0.00,GBP,COMPLETED,1216.26
TRANSFER,Current,2023-01-26 01:12:55,2023-01-26 01:12:56,Depositing savings,-1.20,0.00,GBP,COMPLETED,1215.06
TRANSFER,Current,2023-01-26 06:07:19,2023-01-26 06:07:20,Depositing savings,-5.00,0.00,GBP,COMPLETED,1210.06
CARD_PAYMENT,Current,2023-01-26 01:12:55,2023-01-26 11:18:25,Transport for London,-1.60,0.00,GBP,COMPLETED,1208.46
TRANSFER,Current,2023-01-27 01:13:21,2023-01-27 01:13:22,Depositing savings,-1.80,0.00,GBP,COMPLETED,1206.66
TRANSFER,Current,2023-01-27 06:10:00,2023-01-27 06:10:01,Depositing savings,-5.00,0.00,GBP,COMPLETED,1201.66
CARD_PAYMENT,Current,2023-01-27 01:13:21,2023-01-27 15:29:09,Transport for London,-3.40,0.00,GBP,COMPLETED,1198.26
TRANSFER,Current,2023-01-28 01:12:56,2023-01-28 01:12:56,Depositing savings,-1.20,0.00,GBP,COMPLETED,1197.06
TRANSFER,Current,2023-01-28 06:06:38,2023-01-28 06:06:39,Depositing savings,-5.00,0.00,GBP,COMPLETED,1192.06
CARD_PAYMENT,Current,2023-01-28 01:12:55,2023-01-28 11:32:53,Transport for London,-3.60,0.00,GBP,COMPLETED,1188.46
FEE,Current,2023-01-29 00:25:43,2023-01-29 00:25:43,Metal plan fee,-12.99,0.00,GBP,COMPLETED,1175.47
TRANSFER,Current,2023-01-29 06:05:58,2023-01-29 06:05:59,Depositing savings,-5.00,0.00,GBP,COMPLETED,1170.47
TRANSFER,Current,2023-01-29 08:02:37,2023-01-29 08:02:37,Withdrawing savings,2000.00,0.00,GBP,COMPLETED,3170.47
TRANSFER,Current,2023-01-29 08:05:19,2023-01-29 08:05:20,Withdrawing savings,1000.00,0.00,GBP,COMPLETED,4170.47
TRANSFER,Current,2023-01-29 13:10:07,2023-01-29 13:10:08,Depositing savings,-0.03,0.00,GBP,COMPLETED,4170.44
TRANSFER,Current,2023-01-29 17:45:45,2023-01-29 17:45:46,To MAXIM FALDIN,-60.00,0.00,GBP,COMPLETED,4110.44
TRANSFER,Current,2023-01-29 22:33:03,2023-01-29 22:33:04,Depositing savings,-0.03,0.00,GBP,COMPLETED,4110.41
TRANSFER,Current,2023-01-30 04:53:27,2023-01-30 04:53:28,Depositing savings,-0.03,0.00,GBP,COMPLETED,4110.38
TRANSFER,Current,2023-01-30 06:32:37,2023-01-30 06:32:38,Depositing savings,-5.00,0.00,GBP,COMPLETED,4105.38
TRANSFER,Current,2023-01-30 08:01:59,2023-01-30 08:02:02,To Holly Michael,-2450.00,0.00,GBP,COMPLETED,1655.38
TRANSFER,Current,2023-01-31 00:00:00,2023-01-31 01:01:50,To Virgin Active,-147.00,0.00,GBP,COMPLETED,1508.38
TRANSFER,Current,2023-01-31 01:09:38,2023-01-31 01:09:38,Depositing savings,-1.20,0.00,GBP,COMPLETED,1507.18
TRANSFER,Current,2023-01-31 06:06:28,2023-01-31 06:06:29,Depositing savings,-5.00,0.00,GBP,COMPLETED,1502.18
TRANSFER,Current,2023-01-31 11:20:38,2023-01-31 11:20:38,From WECTORY LTD,1600.12,0.00,GBP,COMPLETED,3102.30
CARD_PAYMENT,Current,2023-01-30 04:53:27,2023-01-31 14:33:10,Netflix,-10.99,0.00,GBP,COMPLETED,3091.31
CARD_PAYMENT,Current,2023-01-29 13:10:07,2023-01-31 14:58:55,Amazon Prime,-8.99,0.00,GBP,COMPLETED,3082.32
CARD_PAYMENT,Current,2023-01-31 01:09:38,2023-01-31 18:01:10,Transport for London,-3.60,0.00,GBP,COMPLETED,3078.72
CARD_PAYMENT,Current,2023-01-29 22:33:03,2023-01-31 22:56:29,Apple,-39.99,0.00,GBP,COMPLETED,3038.73
TRANSFER,Current,2023-02-01 01:14:36,2023-02-01 01:14:37,Depositing savings,-1.80,0.00,GBP,COMPLETED,3036.93
TRANSFER,Current,2023-02-01 06:12:06,2023-02-01 06:12:06,Depositing savings,-5.00,0.00,GBP,COMPLETED,3031.93
CARD_PAYMENT,Current,2023-02-01 01:14:36,2023-02-01 12:18:10,Transport for London,-3.40,0.00,GBP,COMPLETED,3028.53
TRANSFER,Current,2023-02-02 06:07:41,2023-02-02 06:07:41,Depositing savings,-5.00,0.00,GBP,COMPLETED,3023.53
TRANSFER,Current,2023-02-02 08:01:54,2023-02-02 08:01:54,To ALEKSANDRA BALABANOVA,-600.00,0.00,GBP,COMPLETED,2423.53
TRANSFER,Current,2023-02-02 16:44:26,2023-02-02 16:44:26,Depositing savings,-2.70,0.00,GBP,COMPLETED,2420.83
TRANSFER,Current,2023-02-03 03:12:03,2023-02-03 03:12:04,Depositing savings,-1.20,0.00,GBP,COMPLETED,2419.63
TRANSFER,Current,2023-02-03 06:10:20,2023-02-03 06:10:20,Depositing savings,-5.00,0.00,GBP,COMPLETED,2414.63
CARD_PAYMENT,Current,2023-02-02 16:44:26,2023-02-03 09:06:23,Riverside Supermarket,-28.10,0.00,GBP,COMPLETED,2386.53
TRANSFER,Current,2023-02-03 12:37:35,2023-02-03 12:37:36,Depositing savings,-0.90,0.00,GBP,COMPLETED,2385.63
TRANSFER,Current,2023-02-03 13:00:18,2023-02-03 13:00:19,Withdrawing savings,1500.00,0.00,GBP,COMPLETED,3885.63
TRANSFER,Current,2023-02-03 17:26:48,2023-02-03 17:28:07,To Mikhail Balabanov,-2000.00,0.00,GBP,COMPLETED,1885.63
TRANSFER,Current,2023-02-03 22:48:04,2023-02-03 22:48:04,Depositing savings,-3.00,0.00,GBP,COMPLETED,1882.63
TRANSFER,Current,2023-02-04 01:08:31,2023-02-04 01:08:32,Depositing savings,-1.20,0.00,GBP,COMPLETED,1881.43
TRANSFER,Current,2023-02-04 06:06:15,2023-02-04 06:06:16,Depositing savings,-5.00,0.00,GBP,COMPLETED,1876.43
CARD_PAYMENT,Current,2023-02-03 03:12:03,2023-02-04 08:45:54,Transport for London,-1.60,0.00,GBP,COMPLETED,1874.83
CARD_PAYMENT,Current,2023-02-03 12:37:35,2023-02-04 11:17:21,Marugame Udon,-12.70,0.00,GBP,COMPLETED,1862.13
CARD_PAYMENT,Current,2023-02-04 01:08:31,2023-02-04 11:45:37,Transport for London,-1.60,0.00,GBP,COMPLETED,1860.53
CARD_PAYMENT,Current,2023-02-03 22:48:04,2023-02-04 12:14:43,EE,-25.00,0.00,GBP,COMPLETED,1835.53
TRANSFER,Current,2023-02-05 06:06:40,2023-02-05 06:06:40,Depositing savings,-5.00,0.00,GBP,COMPLETED,1830.53
TRANSFER,Current,2023-02-06 06:32:19,2023-02-06 06:32:19,Depositing savings,-5.00,0.00,GBP,COMPLETED,1825.53
TRANSFER,Current,2023-02-06 11:40:19,2023-02-06 11:40:19,Depositing savings,-0.03,0.00,GBP,COMPLETED,1825.50
TRANSFER,Current,2023-02-07 01:09:36,2023-02-07 01:09:37,Depositing savings,-1.20,0.00,GBP,COMPLETED,1824.30
TRANSFER,Current,2023-02-07 06:05:36,2023-02-07 06:05:37,Depositing savings,-5.00,0.00,GBP,COMPLETED,1819.30
CARD_PAYMENT,Current,2023-02-07 01:09:36,2023-02-07 10:50:54,Transport for London,-1.60,0.00,GBP,COMPLETED,1817.70
CARD_PAYMENT,Current,2023-02-06 11:40:19,2023-02-07 14:07:15,Apple,-16.99,0.00,GBP,COMPLETED,1800.71
TRANSFER,Current,2023-02-08 01:11:48,2023-02-08 01:11:48,Depositing savings,-1.20,0.00,GBP,COMPLETED,1799.51
TRANSFER,Current,2023-02-08 06:05:57,2023-02-08 06:05:58,Depositing savings,-5.00,0.00,GBP,COMPLETED,1794.51
CARD_PAYMENT,Current,2023-02-08 01:11:48,2023-02-08 11:41:05,Transport for London,-1.60,0.00,GBP,COMPLETED,1792.91
TRANSFER,Current,2023-02-09 01:12:50,2023-02-09 01:12:51,Depositing savings,-1.20,0.00,GBP,COMPLETED,1791.71
TRANSFER,Current,2023-02-09 06:06:58,2023-02-09 06:06:59,Depositing savings,-5.00,0.00,GBP,COMPLETED,1786.71
CARD_PAYMENT,Current,2023-02-09 01:12:50,2023-02-09 11:18:10,Transport for London,-1.60,0.00,GBP,COMPLETED,1785.11
TRANSFER,Current,2023-02-10 00:00:00,2023-02-10 01:09:23,To Billing Better,-206.64,0.00,GBP,COMPLETED,1578.47
TRANSFER,Current,2023-02-10 01:17:12,2023-02-10 01:17:13,Depositing savings,-1.80,0.00,GBP,COMPLETED,1576.67
TRANSFER,Current,2023-02-10 06:10:54,2023-02-10 06:10:54,Depositing savings,-5.00,0.00,GBP,COMPLETED,1571.67
TRANSFER,Current,2023-02-10 12:47:42,2023-02-10 12:47:45,Depositing savings,-3.00,0.00,GBP,COMPLETED,1568.67
CARD_PAYMENT,Current,2023-02-10 01:17:12,2023-02-10 13:53:45,Transport for London,-3.40,0.00,GBP,COMPLETED,1565.27
TRANSFER,Current,2023-02-11 03:24:59,2023-02-11 03:25:00,Depositing savings,-2.40,0.00,GBP,COMPLETED,1562.87
TRANSFER,Current,2023-02-11 06:06:15,2023-02-11 06:06:15,Depositing savings,-5.00,0.00,GBP,COMPLETED,1557.87
TRANSFER,Current,2023-02-11 09:35:42,2023-02-11 09:35:42,To NATALIA BALABANOVA,-1000.00,0.00,GBP,COMPLETED,557.87
TRANSFER,Current,2023-02-11 09:36:07,2023-02-11 09:36:07,Withdrawing savings,3000.00,0.00,GBP,COMPLETED,3557.87
TRANSFER,Current,2023-02-11 09:39:33,2023-02-11 09:39:33,Depositing savings,-2.13,0.00,GBP,COMPLETED,3555.74
TRANSFER,Current,2023-02-11 12:09:48,2023-02-11 12:09:50,Depositing savings,-0.03,0.00,GBP,COMPLETED,3555.71
CARD_PAYMENT,Current,2023-02-10 12:47:42,2023-02-11 14:19:14,Occ Oxford,-12.00,0.00,GBP,COMPLETED,3543.71
TRANSFER,Current,2023-02-12 06:05:54,2023-02-12 06:05:54,Depositing savings,-5.00,0.00,GBP,COMPLETED,3538.71
CARD_PAYMENT,Current,2023-02-11 03:24:59,2023-02-12 09:04:13,Transport for London,-5.20,0.00,GBP,COMPLETED,3533.51
CARD_PAYMENT,Current,2023-02-11 09:39:33,2023-02-12 10:56:35,American Express,-289.29,0.00,GBP,COMPLETED,3244.22
EXCHANGE,Current,2023-02-12 17:57:24,2023-02-12 17:57:24,Exchanged to EUR,-2218.48,22.18,GBP,COMPLETED,1003.56
TRANSFER,Current,2023-02-13 06:32:07,2023-02-13 06:32:07,Depositing savings,-5.00,0.00,GBP,COMPLETED,998.56
TRANSFER,Current,2023-02-13 12:06:12,2023-02-13 12:06:16,Depositing savings,-0.03,0.00,GBP,COMPLETED,998.53
CARD_PAYMENT,Current,2023-02-11 12:09:45,2023-02-13 13:02:02,Apple,-6.99,0.00,GBP,COMPLETED,991.54
TRANSFER,Current,2023-02-13 23:06:10,2023-02-13 23:06:11,Depositing savings,-3.00,0.00,GBP,COMPLETED,988.54
TRANSFER,Current,2023-02-14 01:09:16,2023-02-14 01:09:16,Depositing savings,-1.20,0.00,GBP,COMPLETED,987.34
TRANSFER,Current,2023-02-14 06:05:22,2023-02-14 06:05:22,Depositing savings,-5.00,0.00,GBP,COMPLETED,982.34
TRANSFER,Current,2023-02-14 10:48:52,2023-02-14 10:48:52,To ALEKSANDRA BALABANOVA,-100.00,0.00,GBP,COMPLETED,882.34
CARD_PAYMENT,Current,2023-02-14 01:09:16,2023-02-14 11:09:58,Transport for London,-1.60,0.00,GBP,COMPLETED,880.74
CARD_PAYMENT,Current,2023-02-13 23:06:10,2023-02-14 11:24:58,EE,-27.00,0.00,GBP,COMPLETED,853.74
CARD_PAYMENT,Current,2023-02-13 12:06:10,2023-02-14 13:16:08,Apple,-5.99,0.00,GBP,COMPLETED,847.75
CARD_PAYMENT,Current,2023-02-15 01:10:48,,Transport for London,-10.50,0.00,GBP,REVERTED,
TRANSFER,Current,2023-02-15 01:10:48,2023-02-15 01:10:48,Depositing savings,-1.50,0.00,GBP,COMPLETED,846.25
TRANSFER,Current,2023-02-15 06:06:39,2023-02-15 06:06:40,Depositing savings,-5.00,0.00,GBP,COMPLETED,841.25
TRANSFER,Current,2023-02-15 17:37:02,2023-02-15 17:37:03,Depositing savings,-3.00,0.00,GBP,COMPLETED,838.25
TRANSFER,Current,2023-02-15 17:48:43,2023-02-15 17:48:44,Depositing savings,-3.00,0.00,GBP,COMPLETED,835.25
TRANSFER,Current,2023-02-15 17:52:14,2023-02-15 17:52:16,Depositing savings,-3.00,0.00,GBP,COMPLETED,832.25
TRANSFER,Current,2023-02-16 01:13:21,2023-02-16 01:13:21,Depositing savings,-1.80,0.00,GBP,COMPLETED,830.45
TRANSFER,Current,2023-02-16 02:29:49,2023-02-16 02:29:49,Depositing savings,-1.20,0.00,GBP,COMPLETED,829.25
TRANSFER,Current,2023-02-16 06:07:11,2023-02-16 06:07:12,Depositing savings,-5.00,0.00,GBP,COMPLETED,824.25
CARD_PAYMENT,Current,2023-02-15 17:52:13,2023-02-16 10:13:58,Land Registry UK,-3.00,0.00,GBP,COMPLETED,821.25
CARD_PAYMENT,Current,2023-02-15 17:48:43,2023-02-16 10:13:58,Land Registry UK,-3.00,0.00,GBP,COMPLETED,818.25
CARD_PAYMENT,Current,2023-02-15 17:37:02,2023-02-16 10:13:59,Land Registry UK,-3.00,0.00,GBP,COMPLETED,815.25
CARD_PAYMENT,Current,2023-02-16 02:29:49,2023-02-16 11:36:25,Transport for London,-1.60,0.00,GBP,COMPLETED,813.65
CARD_PAYMENT,Current,2023-02-16 01:13:20,2023-02-16 11:36:58,Transport for London,-3.40,0.00,GBP,COMPLETED,810.25
TRANSFER,Current,2023-02-17 01:13:39,2023-02-17 01:13:39,Depositing savings,-0.60,0.00,GBP,COMPLETED,809.65
TRANSFER,Current,2023-02-17 06:09:48,2023-02-17 06:09:48,Depositing savings,-5.00,0.00,GBP,COMPLETED,804.65
CARD_PAYMENT,Current,2023-02-17 01:13:39,2023-02-17 12:45:10,Transport for London,-1.80,0.00,GBP,COMPLETED,802.85
TRANSFER,Current,2023-02-18 01:09:36,2023-02-18 01:09:37,Depositing savings,-0.60,0.00,GBP,COMPLETED,802.25
TRANSFER,Current,2023-02-18 06:06:03,2023-02-18 06:06:04,Depositing savings,-5.00,0.00,GBP,COMPLETED,797.25
TRANSFER,Current,2023-02-18 11:33:16,2023-02-18 11:33:17,To ALEKSANDRA BALABANOVA,-300.00,0.00,GBP,COMPLETED,497.25
CARD_PAYMENT,Current,2023-02-18 01:09:36,2023-02-18 15:56:23,Transport for London,-1.80,0.00,GBP,COMPLETED,495.45
TRANSFER,Current,2023-02-19 06:05:41,2023-02-19 06:05:42,Depositing savings,-5.00,0.00,GBP,COMPLETED,490.45
TRANSFER,Current,2023-02-20 06:32:28,2023-02-20 06:32:28,Depositing savings,-5.00,0.00,GBP,COMPLETED,485.45
TRANSFER,Current,2023-02-20 23:09:10,2023-02-20 23:09:10,Depositing savings,-0.03,0.00,GBP,COMPLETED,485.42
TRANSFER,Current,2023-02-20 23:27:37,2023-02-20 23:27:37,Withdrawing savings,307.39,0.00,GBP,COMPLETED,792.81
TRANSFER,Current,2023-02-21 01:10:05,2023-02-21 01:10:06,Depositing savings,-0.60,0.00,GBP,COMPLETED,792.21
TRANSFER,Current,2023-02-21 06:05:23,2023-02-21 06:05:23,Depositing savings,-5.00,0.00,GBP,COMPLETED,787.21
CARD_PAYMENT,Current,2023-02-21 01:10:05,2023-02-21 11:32:43,Transport for London,-1.80,0.00,GBP,COMPLETED,785.41
CARD_PAYMENT,Current,2023-02-20 23:09:09,2023-02-21 13:58:33,Apple,-4.99,0.00,GBP,COMPLETED,780.42
TRANSFER,Current,2023-02-21 21:27:02,2023-02-21 21:27:02,Depositing savings,-0.03,0.00,GBP,COMPLETED,780.39
TRANSFER,Current,2023-02-22 03:21:41,2023-02-22 03:21:42,Depositing savings,-0.03,0.00,GBP,COMPLETED,780.36
TRANSFER,Current,2023-02-22 06:05:42,2023-02-22 06:05:43,Depositing savings,-5.00,0.00,GBP,COMPLETED,775.36
CARD_PAYMENT,Current,2023-02-22 03:21:41,2023-02-22 13:49:44,Apple,-6.99,0.00,GBP,COMPLETED,768.37
CARD_PAYMENT,Current,2023-02-21 21:27:01,2023-02-22 14:29:24,Apple,-4.99,0.00,GBP,COMPLETED,763.38
TRANSFER,Current,2023-02-23 00:50:00,2023-02-23 00:50:01,Depositing savings,-0.03,0.00,GBP,COMPLETED,763.35
TRANSFER,Current,2023-02-23 00:50:32,2023-02-23 00:50:33,Depositing savings,-0.03,0.00,GBP,COMPLETED,763.32
TRANSFER,Current,2023-02-23 00:50:48,2023-02-23 00:50:55,Depositing savings,-0.03,0.00,GBP,COMPLETED,763.29
TRANSFER,Current,2023-02-23 01:11:02,2023-02-23 01:11:03,Depositing savings,-2.70,0.00,GBP,COMPLETED,760.59
TRANSFER,Current,2023-02-23 06:06:55,2023-02-23 06:06:55,Depositing savings,-5.00,0.00,GBP,COMPLETED,755.59
CARD_PAYMENT,Current,2023-02-23 00:50:48,2023-02-23 13:31:28,Apple,-5.99,0.00,GBP,COMPLETED,749.60
CARD_PAYMENT,Current,2023-02-23 00:50:00,2023-02-23 13:31:28,Apple,-5.99,0.00,GBP,COMPLETED,743.61
CARD_PAYMENT,Current,2023-02-23 00:50:32,2023-02-23 13:31:28,Apple,-3.99,0.00,GBP,COMPLETED,739.62
CARD_PAYMENT,Current,2023-02-23 01:11:02,2023-02-23 15:07:56,Transport for London,-5.10,0.00,GBP,COMPLETED,734.52
TRANSFER,Current,2023-02-24 01:14:58,2023-02-24 01:14:58,Depositing savings,-2.40,0.00,GBP,COMPLETED,732.12
TRANSFER,Current,2023-02-24 06:09:45,2023-02-24 06:09:45,Depositing savings,-5.00,0.00,GBP,COMPLETED,727.12
CARD_PAYMENT,Current,2023-02-24 01:14:58,2023-02-24 11:27:17,Transport for London,-5.20,0.00,GBP,COMPLETED,721.92
TRANSFER,Current,2023-02-25 06:06:32,2023-02-25 06:06:32,Depositing savings,-5.00,0.00,GBP,COMPLETED,716.92
CARD_PAYMENT,Current,2023-02-26 01:07:08,,Transport for London,-8.60,0.00,GBP,REVERTED,
TRANSFER,Current,2023-02-26 01:07:08,2023-02-26 01:07:15,Depositing savings,-1.20,0.00,GBP,COMPLETED,715.72
TRANSFER,Current,2023-02-26 01:12:51,2023-02-26 01:12:52,Depositing savings,-2.40,0.00,GBP,COMPLETED,713.32
TRANSFER,Current,2023-02-26 06:06:14,2023-02-26 06:06:14,Depositing savings,-5.00,0.00,GBP,COMPLETED,708.32
CARD_PAYMENT,Current,2023-02-26 01:12:51,2023-02-26 10:53:10,Transport for London,-5.20,0.00,GBP,COMPLETED,703.12
TRANSFER,Current,2023-02-26 20:17:44,2023-02-26 20:17:44,Withdrawing savings,5000.00,0.00,GBP,COMPLETED,5703.12
TRANSFER,Current,2023-02-27 01:02:10,2023-02-27 01:02:11,Depositing savings,-2.40,0.00,GBP,COMPLETED,5700.72
TRANSFER,Current,2023-02-27 00:00:00,2023-02-27 01:13:51,To Tfl Congestn Chrge,-95.00,0.00,GBP,COMPLETED,5605.72
TRANSFER,Current,2023-02-27 06:32:29,2023-02-27 06:32:29,Depositing savings,-5.00,0.00,GBP,COMPLETED,5600.72
CARD_PAYMENT,Current,2023-02-27 01:02:10,2023-02-27 15:06:14,Transport for London,-5.20,0.00,GBP,COMPLETED,5595.52
TRANSFER,Current,2023-02-28 01:08:18,2023-02-28 01:08:18,Depositing savings,-0.60,0.00,GBP,COMPLETED,5594.92
TRANSFER,Current,2023-02-28 00:00:00,2023-02-28 01:08:48,To Virgin Active,-147.00,0.00,GBP,COMPLETED,5447.92
TRANSFER,Current,2023-02-28 05:11:15,2023-02-28 05:11:15,Depositing savings,-0.03,0.00,GBP,COMPLETED,5447.89
TRANSFER,Current,2023-02-28 06:09:20,2023-02-28 06:09:21,Depositing savings,-5.00,0.00,GBP,COMPLETED,5442.89
TRANSFER,Current,2023-02-28 08:03:38,2023-02-28 08:03:41,To Holly Michael,-2450.00,0.00,GBP,COMPLETED,2992.89
CARD_PAYMENT,Current,2023-02-28 01:08:17,2023-02-28 10:47:58,Transport for London,-1.80,0.00,GBP,COMPLETED,2991.09
CARD_PAYMENT,Current,2023-02-28 05:11:14,2023-02-28 11:29:13,Netflix,-10.99,0.00,GBP,COMPLETED,2980.10
TRANSFER,Current,2023-02-28 17:31:17,2023-02-28 17:31:17,Depositing savings,-0.03,0.00,GBP,COMPLETED,2980.07
FEE,Current,2023-03-01 00:33:42,2023-03-01 00:33:42,Metal plan fee,-12.99,0.00,GBP,COMPLETED,2967.08
TRANSFER,Current,2023-03-01 06:12:17,2023-03-01 06:12:17,Depositing savings,-5.00,0.00,GBP,COMPLETED,2962.08
TRANSFER,Current,2023-03-01 09:24:18,2023-03-01 09:24:18,From WECTORY LTD,1549.01,0.00,GBP,COMPLETED,4511.09
CARD_PAYMENT,Current,2023-02-28 17:31:17,2023-03-01 13:31:50,Amazon Prime,-8.99,0.00,GBP,COMPLETED,4502.10
TRANSFER,Current,2023-03-02 06:07:45,2023-03-02 06:07:45,Depositing savings,-5.00,0.00,GBP,COMPLETED,4497.10
TRANSFER,Current,2023-03-02 07:30:47,2023-03-02 07:30:48,To Mikhail Balabanov,-1000.00,0.00,GBP,COMPLETED,3497.10
TRANSFER,Current,2023-03-02 08:02:14,2023-03-02 08:02:15,To NATALIA BALABANOVA,-1000.00,0.00,GBP,COMPLETED,2497.10
TRANSFER,Current,2023-03-02 08:02:15,2023-03-02 08:02:15,To ALEKSANDRA BALABANOVA,-600.00,0.00,GBP,COMPLETED,1897.10
TRANSFER,Current,2023-03-03 01:10:59,2023-03-03 01:11:00,Depositing savings,-0.90,0.00,GBP,COMPLETED,1896.20
TRANSFER,Current,2023-03-03 06:10:21,2023-03-03 06:10:21,Depositing savings,-5.00,0.00,GBP,COMPLETED,1891.20
CARD_PAYMENT,Current,2023-03-03 01:10:59,2023-03-03 11:53:50,Transport for London,-7.70,0.00,GBP,COMPLETED,1883.50
TRANSFER,Current,2023-03-04 06:06:20,2023-03-04 06:06:20,Depositing savings,-5.00,0.00,GBP,COMPLETED,1878.50
TRANSFER,Current,2023-03-04 12:15:39,2023-03-04 12:15:40,Depositing savings,-1.05,0.00,GBP,COMPLETED,1877.45
TRANSFER,Current,2023-03-04 15:30:38,2023-03-04 15:30:39,Depositing savings,-0.03,0.00,GBP,COMPLETED,1877.42
TRANSFER,Current,2023-03-05 06:06:43,2023-03-05 06:06:44,Depositing savings,-5.00,0.00,GBP,COMPLETED,1872.42
TRANSFER,Current,2023-03-05 11:37:48,2023-03-05 11:37:48,Depositing savings,-2.34,0.00,GBP,COMPLETED,1870.08
CARD_PAYMENT,Current,2023-03-04 12:15:39,2023-03-05 13:58:00,PayByPhone,-3.65,0.00,GBP,COMPLETED,1866.43
CARD_PAYMENT,Current,2023-03-04 15:30:37,2023-03-05 15:28:09,Apple,-4.99,0.00,GBP,COMPLETED,1861.44
TRANSFER,Current,2023-03-05 22:53:44,2023-03-05 22:53:45,Depositing savings,-3.00,0.00,GBP,COMPLETED,1858.44
TRANSFER,Current,2023-03-06 06:32:21,2023-03-06 06:32:22,Depositing savings,-5.00,0.00,GBP,COMPLETED,1853.44
CARD_PAYMENT,Current,2023-03-05 11:37:48,2023-03-06 10:29:19,The Royal Borough of Kensington and Chelsea,-3.22,0.00,GBP,COMPLETED,1850.22
CARD_PAYMENT,Current,2023-03-05 22:53:41,2023-03-06 11:35:09,EE,-25.00,0.00,GBP,COMPLETED,1825.22
TRANSFER,Current,2023-03-06 11:43:53,2023-03-06 11:43:54,Depositing savings,-0.03,0.00,GBP,COMPLETED,1825.19
TRANSFER,Current,2023-03-07 01:08:56,2023-03-07 01:08:56,Depositing savings,-0.30,0.00,GBP,COMPLETED,1824.89
TRANSFER,Current,2023-03-07 06:05:39,2023-03-07 06:05:39,Depositing savings,-5.00,0.00,GBP,COMPLETED,1819.89
CARD_PAYMENT,Current,2023-03-07 01:08:56,2023-03-07 10:46:49,Transport for London,-1.90,0.00,GBP,COMPLETED,1817.99
CARD_PAYMENT,Current,2023-03-06 11:43:53,2023-03-07 13:36:30,Apple,-16.99,0.00,GBP,COMPLETED,1801.00
TRANSFER,Current,2023-03-08 01:13:15,2023-03-08 01:13:16,Depositing savings,-0.90,0.00,GBP,COMPLETED,1800.10
TRANSFER,Current,2023-03-08 06:06:00,2023-03-08 06:06:00,Depositing savings,-5.00,0.00,GBP,COMPLETED,1795.10
CARD_PAYMENT,Current,2023-03-08 01:13:10,2023-03-08 16:12:11,Transport for London,-3.70,0.00,GBP,COMPLETED,1791.40
TRANSFER,Current,2023-03-09 01:10:55,2023-03-09 01:10:55,Depositing savings,-0.60,0.00,GBP,COMPLETED,1790.80
TRANSFER,Current,2023-03-09 06:06:59,2023-03-09 06:07:00,Depositing savings,-5.00,0.00,GBP,COMPLETED,1785.80
CARD_PAYMENT,Current,2023-03-09 01:10:55,2023-03-09 11:57:03,Transport for London,-1.80,0.00,GBP,COMPLETED,1784.00
TRANSFER,Current,2023-03-10 00:00:00,2023-03-10 01:11:23,To Billing Better,-174.00,0.00,GBP,COMPLETED,1610.00
TRANSFER,Current,2023-03-10 01:11:25,2023-03-10 01:11:25,Depositing savings,-0.30,0.00,GBP,COMPLETED,1609.70
TRANSFER,Current,2023-03-10 06:10:56,2023-03-10 06:10:56,Depositing savings,-5.00,0.00,GBP,COMPLETED,1604.70
TRANSFER,Current,2023-03-10 13:38:59,2023-03-10 13:38:59,Depositing savings,-1.11,0.00,GBP,COMPLETED,1603.59
CARD_PAYMENT,Current,2023-03-10 01:11:24,2023-03-10 16:06:56,Transport for London,-1.90,0.00,GBP,COMPLETED,1601.69
TRANSFER,Current,2023-03-11 01:09:06,2023-03-11 01:09:07,Depositing savings,-0.30,0.00,GBP,COMPLETED,1601.39
TRANSFER,Current,2023-03-11 06:06:18,2023-03-11 06:06:18,Depositing savings,-5.00,0.00,GBP,COMPLETED,1596.39
CARD_PAYMENT,Current,2023-03-11 01:09:06,2023-03-11 11:29:38,Transport for London,-1.90,0.00,GBP,COMPLETED,1594.49
TRANSFER,Current,2023-03-11 12:09:08,2023-03-11 12:09:08,Depositing savings,-0.03,0.00,GBP,COMPLETED,1594.46
CARD_PAYMENT,Current,2023-03-10 13:38:58,2023-03-11 14:40:01,SpeedProxies,-16.63,0.00,GBP,COMPLETED,1577.83
TRANSFER,Current,2023-03-11 21:40:05,2023-03-11 21:40:05,Depositing savings,-0.03,0.00,GBP,COMPLETED,1577.80
TRANSFER,Current,2023-03-11 21:40:27,2023-03-11 21:40:27,Depositing savings,-0.03,0.00,GBP,COMPLETED,1577.77
TRANSFER,Current,2023-03-11 21:40:53,2023-03-11 21:40:54,Depositing savings,-0.03,0.00,GBP,COMPLETED,1577.74
TRANSFER,Current,2023-03-12 06:05:58,2023-03-12 06:05:58,Depositing savings,-5.00,0.00,GBP,COMPLETED,1572.74
TRANSFER,Current,2023-03-12 09:33:11,2023-03-12 09:33:23,To Mikhail Balabanov,-1000.00,0.00,GBP,COMPLETED,572.74
CARD_PAYMENT,Current,2023-03-11 12:09:07,2023-03-12 13:02:48,Apple,-6.99,0.00,GBP,COMPLETED,565.75
CARD_PAYMENT,Current,2023-03-11 21:40:27,2023-03-12 14:19:16,Apple,-4.99,0.00,GBP,COMPLETED,560.76
CARD_PAYMENT,Current,2023-03-11 21:40:05,2023-03-12 14:19:16,Apple,-4.99,0.00,GBP,COMPLETED,555.77
CARD_PAYMENT,Current,2023-03-11 21:40:53,2023-03-12 14:19:16,Apple,-4.99,0.00,GBP,COMPLETED,550.78
TRANSFER,Current,2023-03-13 06:32:09,2023-03-13 06:32:09,Depositing savings,-5.00,0.00,GBP,COMPLETED,545.78
TRANSFER,Current,2023-03-13 11:06:13,2023-03-13 11:06:14,Depositing savings,-0.03,0.00,GBP,COMPLETED,545.75
TRANSFER,Current,2023-03-14 01:39:52,2023-03-14 01:39:52,Depositing savings,-0.30,0.00,GBP,COMPLETED,545.45
TRANSFER,Current,2023-03-14 06:05:24,2023-03-14 06:05:24,Depositing savings,-5.00,0.00,GBP,COMPLETED,540.45
CARD_PAYMENT,Current,2023-03-14 01:39:52,2023-03-14 12:21:14,Transport for London,-1.90,0.00,GBP,COMPLETED,538.55
TRANSFER,Current,2023-03-14 13:48:03,2023-03-14 13:48:05,Depositing savings,-1.50,0.00,GBP,COMPLETED,537.05
TRANSFER,Current,2023-03-14 14:40:53,2023-03-14 14:40:53,Depositing savings,-1.50,0.00,GBP,COMPLETED,535.55
CARD_PAYMENT,Current,2023-03-13 11:06:13,2023-03-14 14:55:02,Apple,-5.99,0.00,GBP,COMPLETED,529.56
TRANSFER,Current,2023-03-15 01:13:04,2023-03-15 01:13:04,Depositing savings,-0.30,0.00,GBP,COMPLETED,529.26
TRANSFER,Current,2023-03-15 06:06:39,2023-03-15 06:06:39,Depositing savings,-5.00,0.00,GBP,COMPLETED,524.26
CARD_PAYMENT,Current,2023-03-14 13:48:01,2023-03-15 11:44:59,PayByPhone,-1.50,0.00,GBP,COMPLETED,522.76
CARD_PAYMENT,Current,2023-03-14 14:40:52,2023-03-15 11:44:59,PayByPhone,-1.50,0.00,GBP,COMPLETED,521.26
CARD_PAYMENT,Current,2023-03-15 01:13:03,2023-03-15 12:19:51,Transport for London,-1.90,0.00,GBP,COMPLETED,519.36
TRANSFER,Current,2023-03-15 23:03:16,2023-03-15 23:03:17,Depositing savings,-3.00,0.00,GBP,COMPLETED,516.36
TRANSFER,Current,2023-03-16 01:06:32,2023-03-16 01:06:33,Depositing savings,-1.20,0.00,GBP,COMPLETED,515.16
TRANSFER,Current,2023-03-16 06:07:13,2023-03-16 06:07:14,Depositing savings,-5.00,0.00,GBP,COMPLETED,510.16
CARD_PAYMENT,Current,2023-03-16 01:06:32,2023-03-16 16:27:29,Transport for London,-5.60,0.00,GBP,COMPLETED,504.56
CARD_PAYMENT,Current,2023-03-15 23:03:16,2023-03-16 17:02:40,EE,-27.00,0.00,GBP,COMPLETED,477.56
TRANSFER,Current,2023-03-16 17:13:12,2023-03-16 17:13:13,Depositing savings,-0.03,0.00,GBP,COMPLETED,477.53
TRANSFER,Current,2023-03-17 06:09:53,2023-03-17 06:09:53,Depositing savings,-5.00,0.00,GBP,COMPLETED,472.53
TRANSFER,Current,2023-03-18 01:09:58,2023-03-18 01:09:59,Depositing savings,-2.70,0.00,GBP,COMPLETED,469.83
TRANSFER,Current,2023-03-18 06:06:11,2023-03-18 06:06:12,Depositing savings,-5.00,0.00,GBP,COMPLETED,464.83
TRANSFER,Current,2023-03-18 10:27:44,2023-03-18 10:27:45,Depositing savings,-3.00,0.00,GBP,COMPLETED,461.83
TRANSFER,Current,2023-03-18 13:43:51,2023-03-18 13:43:51,Withdrawing savings,5000.00,0.00,GBP,COMPLETED,5461.83
TRANSFER,Current,2023-03-19 06:05:45,2023-03-19 06:05:45,Depositing savings,-5.00,0.00,GBP,COMPLETED,5456.83
TRANSFER,Current,2023-03-20 06:32:17,2023-03-20 06:32:18,Depositing savings,-5.00,0.00,GBP,COMPLETED,5451.83
CARD_PAYMENT,Current,2023-03-18 01:09:58,2023-03-20 17:11:22,Transport for London,-8.10,0.00,GBP,COMPLETED,5443.73
CARD_PAYMENT,Current,2023-03-16 17:13:12,2023-03-20 19:44:31,Apple,-4.99,0.00,GBP,COMPLETED,5438.74
CARD_PAYMENT,Current,2023-03-18 10:27:44,2023-03-20 22:48:58,PayByPhone,-3.00,0.00,GBP,COMPLETED,5435.74
TRANSFER,Current,2023-03-21 06:05:26,2023-03-21 06:05:27,Depositing savings,-5.00,0.00,GBP,COMPLETED,5430.74
TRANSFER,Current,2023-03-22 01:10:22,2023-03-22 01:10:23,Depositing savings,-0.30,0.00,GBP,COMPLETED,5430.44
TRANSFER,Current,2023-03-22 02:17:36,2023-03-22 02:17:36,Depositing savings,-0.03,0.00,GBP,COMPLETED,5430.41
TRANSFER,Current,2023-03-22 06:05:45,2023-03-22 06:05:45,Depositing savings,-5.00,0.00,GBP,COMPLETED,5425.41
TRANSFER,Current,2023-03-22 10:53:12,2023-03-22 10:53:13,Depositing savings,-1.56,0.00,GBP,COMPLETED,5423.85
CARD_PAYMENT,Current,2023-03-22 02:17:36,2023-03-22 12:23:24,Apple,-6.99,0.00,GBP,COMPLETED,5416.86
CARD_PAYMENT,Current,2023-03-22 01:10:22,2023-03-22 13:37:15,Transport for London,-1.90,0.00,GBP,COMPLETED,5414.96
TRANSFER,Current,2023-03-23 01:10:51,2023-03-23 01:10:51,Depositing savings,-1.20,0.00,GBP,COMPLETED,5413.76
TRANSFER,Current,2023-03-23 06:06:58,2023-03-23 06:06:59,Depositing savings,-5.00,0.00,GBP,COMPLETED,5408.76
TRANSFER,Current,2023-03-23 10:31:35,2023-03-23 10:31:36,Depositing savings,-0.93,0.00,GBP,COMPLETED,5407.83
TRANSFER,Current,2023-03-23 12:51:05,2023-03-23 12:51:05,Depositing savings,-3.00,0.00,GBP,COMPLETED,5404.83
TRANSFER,Current,2023-03-23 12:55:55,2023-03-23 12:55:57,To Mikhail Balabanov,-1000.00,0.00,GBP,COMPLETED,4404.83
CARD_PAYMENT,Current,2023-03-23 01:10:51,2023-03-23 13:32:22,Transport for London,-3.60,0.00,GBP,COMPLETED,4401.23
TRANSFER,Current,2023-03-24 01:10:38,2023-03-24 01:10:38,Depositing savings,-0.90,0.00,GBP,COMPLETED,4400.33
TRANSFER,Current,2023-03-24 06:09:52,2023-03-24 06:09:52,Depositing savings,-5.00,0.00,GBP,COMPLETED,4395.33
CARD_PAYMENT,Current,2023-03-23 10:31:35,2023-03-24 10:09:48,News On The Wharf,-5.69,0.00,GBP,COMPLETED,4389.64
CARD_PAYMENT,Current,2023-03-24 01:10:38,2023-03-24 12:35:23,Transport for London,-3.70,0.00,GBP,COMPLETED,4385.94
TRANSFER,Current,2023-03-25 01:11:19,2023-03-25 01:11:20,Depositing savings,-1.50,0.00,GBP,COMPLETED,4384.44
TRANSFER,Current,2023-03-25 06:06:37,2023-03-25 06:06:37,Depositing savings,-5.00,0.00,GBP,COMPLETED,4379.44
CARD_PAYMENT,Current,2023-03-23 12:51:04,2023-03-25 10:21:42,Starbucks,-2.00,0.00,GBP,COMPLETED,4377.44
CARD_PAYMENT,Current,2023-03-25 01:11:19,2023-03-25 13:08:33,Transport for London,-7.50,0.00,GBP,COMPLETED,4369.94
TRANSFER,Current,2023-03-26 07:06:16,2023-03-26 07:06:17,Depositing savings,-5.00,0.00,GBP,COMPLETED,4364.94
TRANSFER,Current,2023-03-27 01:00:00,2023-03-27 01:14:15,To Tfl Congestn Chrge,-15.00,0.00,GBP,COMPLETED,4349.94
TRANSFER,Current,2023-03-27 07:32:05,2023-03-27 07:32:05,Depositing savings,-5.00,0.00,GBP,COMPLETED,4344.94
TRANSFER,Current,2023-03-27 08:48:17,2023-03-27 08:48:17,Depositing savings,-3.00,0.00,GBP,COMPLETED,4341.94
TRANSFER,Current,2023-03-28 07:06:08,2023-03-28 07:06:08,Depositing savings,-5.00,0.00,GBP,COMPLETED,4336.94
CARD_PAYMENT,Current,2023-03-22 10:53:10,2023-03-28 09:04:05,Amazon,-112.48,0.00,GBP,COMPLETED,4224.46
TRANSFER,Current,2023-03-28 09:23:14,2023-03-28 09:23:14,Depositing savings,-1.26,0.00,GBP,COMPLETED,4223.20
CARD_PAYMENT,Current,2023-03-27 08:48:17,2023-03-28 10:53:55,Pedn Olva Hotel,-99.00,0.00,GBP,COMPLETED,4124.20
FEE,Current,2023-03-29 01:11:53,2023-03-29 01:11:53,Metal plan fee,-12.99,0.00,GBP,COMPLETED,4111.21
TRANSFER,Current,2023-03-29 01:12:22,2023-03-29 01:12:23,Depositing savings,-0.30,0.00,GBP,COMPLETED,4110.91
TRANSFER,Current,2023-03-29 07:06:02,2023-03-29 07:06:03,Depositing savings,-5.00,0.00,GBP,COMPLETED,4105.91
CARD_PAYMENT,Current,2023-03-28 09:23:13,2023-03-29 09:49:42,Riverside Stores,-45.58,0.00,GBP,COMPLETED,4060.33
CARD_PAYMENT,Current,2023-03-29 01:12:22,2023-03-29 12:29:48,Transport for London,-1.90,0.00,GBP,COMPLETED,4058.43
TRANSFER,Current,2023-03-29 13:51:40,2023-03-29 13:51:41,Depositing savings,-0.03,0.00,GBP,COMPLETED,4058.40
TRANSFER,Current,2023-03-30 01:11:58,2023-03-30 01:11:59,Depositing savings,-1.20,0.00,GBP,COMPLETED,4057.20
TRANSFER,Current,2023-03-30 04:29:40,2023-03-30 04:29:41,Depositing savings,-0.03,0.00,GBP,COMPLETED,4057.17
TRANSFER,Current,2023-03-30 07:07:33,2023-03-30 07:07:33,Depositing savings,-5.00,0.00,GBP,COMPLETED,4052.17
TRANSFER,Current,2023-03-30 09:02:01,2023-03-30 09:02:04,To Holly Michael,-2450.00,0.00,GBP,COMPLETED,1602.17
CARD_PAYMENT,Current,2023-03-29 13:51:39,2023-03-30 09:43:08,Amazon Prime,-8.99,0.00,GBP,COMPLETED,1593.18
CARD_PAYMENT,Current,2023-03-30 04:29:40,2023-03-30 11:26:32,Netflix,-10.99,0.00,GBP,COMPLETED,1582.19
CARD_PAYMENT,Current,2023-03-30 01:11:58,2023-03-30 11:34:03,Transport for London,-5.60,0.00,GBP,COMPLETED,1576.59
TRANSFER,Current,2023-03-31 01:00:00,2023-03-31 01:00:49,To Virgin Active,-147.00,0.00,GBP,COMPLETED,1429.59
TRANSFER,Current,2023-03-31 01:11:40,2023-03-31 01:11:40,Depositing savings,-0.60,0.00,GBP,COMPLETED,1428.99
TRANSFER,Current,2023-03-31 07:10:55,2023-03-31 07:10:55,Depositing savings,-5.00,0.00,GBP,COMPLETED,1423.99
CARD_PAYMENT,Current,2023-03-31 01:11:40,2023-03-31 13:21:06,Transport for London,-1.80,0.00,GBP,COMPLETED,1422.19
TRANSFER,Current,2023-03-31 15:46:52,2023-03-31 15:46:55,From WECTORY LTD,1549.02,0.00,GBP,COMPLETED,2971.21
TRANSFER,Current,2023-04-01 01:08:40,2023-04-01 01:08:41,Depositing savings,-0.60,0.00,GBP,COMPLETED,2970.61
TRANSFER,Current,2023-04-01 07:12:39,2023-04-01 07:12:39,Depositing savings,-5.00,0.00,GBP,COMPLETED,2965.61
CARD_PAYMENT,Current,2023-04-01 01:08:40,2023-04-01 13:17:23,Transport for London,-3.80,0.00,GBP,COMPLETED,2961.81
TRANSFER,Current,2023-04-02 07:06:35,2023-04-02 07:06:36,Depositing savings,-5.00,0.00,GBP,COMPLETED,2956.81
TRANSFER,Current,2023-04-02 09:02:11,2023-04-02 09:06:05,To NATALIA BALABANOVA,-1000.00,0.00,GBP,COMPLETED,1956.81
TRANSFER,Current,2023-04-02 09:02:11,2023-04-02 09:07:10,To ALEKSANDRA BALABANOVA,-600.00,0.00,GBP,COMPLETED,1356.81
TRANSFER,Current,2023-04-03 07:32:25,2023-04-03 07:32:25,Depositing savings,-5.00,0.00,GBP,COMPLETED,1351.81
TRANSFER,Current,2023-04-04 01:09:26,2023-04-04 01:09:26,Depositing savings,-0.90,0.00,GBP,COMPLETED,1350.91
TRANSFER,Current,2023-04-04 07:05:43,2023-04-04 07:05:43,Depositing savings,-5.00,0.00,GBP,COMPLETED,1345.91
CARD_PAYMENT,Current,2023-04-04 01:09:26,2023-04-04 11:27:05,Transport for London,-3.70,0.00,GBP,COMPLETED,1342.21
TRANSFER,Current,2023-04-04 11:27:33,2023-04-04 11:27:34,Depositing savings,-3.00,0.00,GBP,COMPLETED,1339.21
TRANSFER,Current,2023-04-04 22:50:43,2023-04-04 22:50:43,Depositing savings,-3.00,0.00,GBP,COMPLETED,1336.21
TRANSFER,Current,2023-04-05 02:23:53,2023-04-05 02:23:53,Depositing savings,-0.60,0.00,GBP,COMPLETED,1335.61
TRANSFER,Current,2023-04-05 07:06:42,2023-04-05 07:06:42,Depositing savings,-5.00,0.00,GBP,COMPLETED,1330.61
TRANSFER,Current,2023-04-05 08:21:49,2023-04-05 08:21:55,To Mikhail Balabanov,-1000.00,0.00,GBP,COMPLETED,330.61
TRANSFER,Current,2023-04-05 08:22:20,2023-04-05 08:22:21,Withdrawing savings,281.42,0.00,GBP,COMPLETED,612.03
TRANSFER,Current,2023-04-05 08:22:44,2023-04-05 08:22:44,To GBP,1.04,0.00,GBP,COMPLETED,613.07
TRANSFER,Current,2023-04-05 08:23:07,2023-04-05 08:23:07,Withdrawing savings,1099.11,0.00,GBP,COMPLETED,1712.18
CARD_PAYMENT,Current,2023-04-04 11:27:29,2023-04-05 11:05:11,Starbucks,-2.00,0.00,GBP,COMPLETED,1710.18
CARD_PAYMENT,Current,2023-04-04 22:50:42,2023-04-05 11:41:29,EE,-25.00,0.00,GBP,COMPLETED,1685.18
TRANSFER,Deposit,2022-04-06 07:05:16,2022-04-06 07:05:16,To GBP Rainy day,5.00,0.00,GBP,COMPLETED,125.76
TRANSFER,Deposit,2022-04-06 09:48:28,2022-04-06 09:48:28,To GBP Rainy day,2.10,0.00,GBP,COMPLETED,127.86
TRANSFER,Deposit,2022-04-06 11:24:18,2022-04-06 11:24:18,To GBP Rainy day,1.95,0.00,GBP,COMPLETED,129.81
TRANSFER,Deposit,2022-04-06 15:02:47,2022-04-06 15:02:47,To GBP Rainy day,1.65,0.00,GBP,COMPLETED,131.46
TRANSFER,Deposit,2022-04-06 18:44:41,2022-04-06 18:44:41,To GBP Rainy day,0.30,0.00,GBP,COMPLETED,131.76
TRANSFER,Deposit,2022-04-06 18:51:58,2022-04-06 18:51:58,To GBP Rainy day,2.70,0.00,GBP,COMPLETED,134.46
TRANSFER,Deposit,2022-04-07 01:40:18,2022-04-07 01:40:18,To GBP Rainy day,0.60,0.00,GBP,COMPLETED,135.06
TRANSFER,Deposit,2022-04-07 07:06:08,2022-04-07 07:06:08,To GBP Rainy day,5.00,0.00,GBP,COMPLETED,140.06
TRANSFER,Deposit,2022-04-07 09:39:48,2022-04-07 09:39:48,To GBP Rainy day,1.95,0.00,GBP,COMPLETED,142.01
TRANSFER,Deposit,2022-04-07 11:09:32,2022-04-07 11:09:32,To GBP Rainy day,1.95,0.00,GBP,COMPLETED,143.96
TRANSFER,Deposit,2022-04-07 13:19:52,2022-04-07 13:19:52,To GBP Rainy day,0.03,0.00,GBP,COMPLETED,143.99
TRANSFER,Deposit,2022-04-07 18:07:53,2022-04-07 18:07:53,To GBP Rainy day,1.65,0.00,GBP,COMPLETED,145.64
TRANSFER,Deposit,2022-04-07 18:16:11,2022-04-07 18:16:11,To GBP Rainy day,3.00,0.00,GBP,COMPLETED,148.64
TRANSFER,Deposit,2022-04-07 18:43:56,2022-04-07 18:43:56,To GBP Rainy day,3.00,0.00,GBP,COMPLETED,151.64
TRANSFER,Deposit,2022-04-08 07:08:08,2022-04-08 07:08:08,To GBP Rainy day,5.00,0.00,GBP,COMPLETED,156.64
TRANSFER,Deposit,2022-04-08 09:34:24,2022-04-08 09:34:24,To GBP Rainy day,1.95,0.00,GBP,COMPLETED,158.59
TRANSFER,Deposit,2022-04-08 10:42:27,2022-04-08 10:42:27,To GBP Rainy day,1.95,0.00,GBP,COMPLETED,160.54
TRANSFER,Deposit,2022-04-08 13:13:59,2022-04-08 13:13:59,To GBP Rainy day,3.00,0.00,GBP,COMPLETED,163.54
TRANSFER,Deposit,2022-04-08 18:54:51,2022-04-08 18:54:51,To GBP Rainy day,1.50,0.00,GBP,COMPLETED,165.04
TRANSFER,Deposit,2022-04-09 07:05:18,2022-04-09 07:05:18,To GBP Rainy day,5.00,0.00,GBP,COMPLETED,170.04
TRANSFER,Deposit,2022-04-09 19:41:03,2022-04-09 19:41:03,To GBP Rainy day,3.00,0.00,GBP,COMPLETED,173.04
TRANSFER,Deposit,2022-04-10 01:37:42,2022-04-10 01:37:42,To GBP Rainy day,1.20,0.00,GBP,COMPLETED,174.24
TRANSFER,Deposit,2022-04-10 07:06:22,2022-04-10 07:06:22,To GBP Rainy day,5.00,0.00,GBP,COMPLETED,179.24
TRANSFER,Deposit,2022-04-10 12:13:16,2022-04-10 12:13:16,To GBP Rainy day,1.59,0.00,GBP,COMPLETED,180.83
TRANSFER,Deposit,2022-04-10 19:21:40,2022-04-10 19:21:40,To GBP Rainy day,1.50,0.00,GBP,COMPLETED,182.33
TRANSFER,Deposit,2022-04-10 19:21:55,2022-04-10 19:21:55,To GBP Rainy day,1.50,0.00,GBP,COMPLETED,183.83
TRANSFER,Deposit,2022-04-10 19:33:32,2022-04-10 19:33:32,To GBP Rainy day,2.40,0.00,GBP,COMPLETED,186.23
TRANSFER,Deposit,2022-04-10 19:57:09,2022-04-10 19:57:09,To GBP Rainy day,2.40,0.00,GBP,COMPLETED,188.63
TRANSFER,Deposit,2022-04-10 20:53:26,2022-04-10 20:53:26,To GBP Rainy day,2.70,0.00,GBP,COMPLETED,191.33
TRANSFER,Deposit,2022-04-11 01:21:21,2022-04-11 01:21:21,To GBP Rainy day,2.40,0.00,GBP,COMPLETED,193.73
TRANSFER,Deposit,2022-04-11 07:25:24,2022-04-11 07:25:24,To GBP Rainy day,5.00,0.00,GBP,COMPLETED,198.73
TRANSFER,Deposit,2022-04-11 09:21:02,2022-04-11 09:21:02,To GBP Rainy day,1.95,0.00,GBP,COMPLETED,200.68
TRANSFER,Deposit,2022-04-11 12:08:20,2022-04-11 12:08:20,To GBP Rainy day,0.03,0.00,GBP,COMPLETED,200.71
TRANSFER,Deposit,2022-04-11 12:59:20,2022-04-11 12:59:20,To GBP Rainy day,1.68,0.00,GBP,COMPLETED,202.39
TRANSFER,Deposit,2022-04-11 13:03:37,2022-04-11 13:03:37,To GBP Rainy day,3.00,0.00,GBP,COMPLETED,205.39
TRANSFER,Deposit,2022-04-11 20:34:38,2022-04-11 20:34:38,To GBP Rainy day,3.00,0.00,GBP,COMPLETED,208.39
TRANSFER,Deposit,2022-04-12 01:05:15,2022-04-12 01:05:15,To GBP Rainy day,2.40,0.00,GBP,COMPLETED,210.79
TRANSFER,Deposit,2022-04-12 01:08:16,2022-04-12 01:08:16,To GBP Rainy day,2.70,0.00,GBP,COMPLETED,213.49
TRANSFER,Deposit,2022-04-12 01:16:57,2022-04-12 01:16:57,To GBP Rainy day,2.70,0.00,GBP,COMPLETED,216.19
TRANSFER,Deposit,2022-04-12 01:39:46,2022-04-12 01:39:46,To GBP Rainy day,2.22,0.00,GBP,COMPLETED,218.41
TRANSFER,Deposit,2022-04-12 03:34:17,2022-04-12 03:34:17,To GBP Rainy day,1.50,0.00,GBP,COMPLETED,219.91
TRANSFER,Deposit,2022-04-12 07:05:03,2022-04-12 07:05:03,To GBP Rainy day,5.00,0.00,GBP,COMPLETED,224.91
TRANSFER,Deposit,2022-04-12 10:17:05,2022-04-12 10:17:05,To GBP Rainy day,1.95,0.00,GBP,COMPLETED,226.86
TRANSFER,Deposit,2022-04-12 11:27:45,2022-04-12 11:27:45,To GBP Rainy day,1.95,0.00,GBP,COMPLETED,228.81
TRANSFER,Deposit,2022-04-12 17:56:22,2022-04-12 17:56:22,To GBP Rainy day,1.05,0.00,GBP,COMPLETED,229.86
TRANSFER,Deposit,2022-04-12 18:23:44,2022-04-12 18:23:44,To GBP Rainy day,1.80,0.00,GBP,COMPLETED,231.66
TRANSFER,Deposit,2022-04-13 07:05:05,2022-04-13 07:05:05,To GBP Rainy day,5.00,0.00,GBP,COMPLETED,236.66
TRANSFER,Deposit,2022-04-13 09:56:16,2022-04-13 09:56:16,To GBP Rainy day,1.95,0.00,GBP,COMPLETED,238.61
TRANSFER,Deposit,2022-04-13 13:26:34,2022-04-13 13:26:34,To GBP Rainy day,1.95,0.00,GBP,COMPLETED,240.56
TRANSFER,Deposit,2022-04-13 14:55:04,2022-04-13 14:55:04,To GBP Rainy day,1.68,0.00,GBP,COMPLETED,242.24
TRANSFER,Deposit,2022-04-13 17:32:05,2022-04-13 17:32:05,To GBP Rainy day,2.43,0.00,GBP,COMPLETED,244.67
TRANSFER,Deposit,2022-04-13 17:40:10,2022-04-13 17:40:10,To GBP Rainy day,3.00,0.00,GBP,COMPLETED,247.67
TRANSFER,Deposit,2022-04-13 21:35:56,2022-04-13 21:35:56,To GBP Rainy day,1.95,0.00,GBP,COMPLETED,249.62
TRANSFER,Deposit,2022-04-13 21:55:50,2022-04-13 21:55:50,To GBP Rainy day,2.85,0.00,GBP,COMPLETED,252.47
TRANSFER,Deposit,2022-04-14 07:05:58,2022-04-14 07:05:58,To GBP Rainy day,5.00,0.00,GBP,COMPLETED,257.47
TRANSFER,Deposit,2022-04-14 09:30:45,2022-04-14 09:30:45,To GBP Rainy day,1.95,0.00,GBP,COMPLETED,259.42
TRANSFER,Deposit,2022-04-14 11:03:30,2022-04-14 11:03:30,To GBP Rainy day,0.45,0.00,GBP,COMPLETED,259.87
TRANSFER,Deposit,2022-04-14 12:02:14,2022-04-14 12:02:14,To GBP Rainy day,3.00,0.00,GBP,COMPLETED,262.87
TRANSFER,Deposit,2022-04-14 14:09:35,2022-04-14 14:09:35,To GBP Rainy day,3.00,0.00,GBP,COMPLETED,265.87
TRANSFER,Deposit,2022-04-14 17:38:11,2022-04-14 17:38:11,To GBP Rainy day,1.80,0.00,GBP,COMPLETED,267.67
TRANSFER,Deposit,2022-04-15 07:08:43,2022-04-15 07:08:43,To GBP Rainy day,5.00,0.00,GBP,COMPLETED,272.67
TRANSFER,Deposit,2022-04-15 14:00:26,2022-04-15 14:00:26,To GBP Rainy day,1.50,0.00,GBP,COMPLETED,274.17
TRANSFER,Deposit,2022-04-15 14:23:37,2022-04-15 14:23:37,To GBP Rainy day,2.40,0.00,GBP,COMPLETED,276.57
TRANSFER,Deposit,2022-04-15 16:10:40,2022-04-15 16:10:40,To GBP Rainy day,3.00,0.00,GBP,COMPLETED,279.57
TRANSFER,Deposit,2022-04-15 17:41:08,2022-04-15 17:41:08,To GBP Rainy day,3.00,0.00,GBP,COMPLETED,282.57
TRANSFER,Deposit,2022-04-15 19:04:24,2022-04-15 19:04:24,To GBP Rainy day,1.65,0.00,GBP,COMPLETED,284.22
TRANSFER,Deposit,2022-04-15 19:18:45,2022-04-15 19:18:45,To GBP Rainy day,1.50,0.00,GBP,COMPLETED,285.72
TRANSFER,Deposit,2022-04-16 07:05:28,2022-04-16 07:05:28,To GBP Rainy day,5.00,0.00,GBP,COMPLETED,290.72
TRANSFER,Deposit,2022-04-16 11:56:08,2022-04-16 11:56:08,To GBP Rainy day,1.38,0.00,GBP,COMPLETED,292.10
TRANSFER,Deposit,2022-04-16 13:19:04,2022-04-16 13:19:04,To GBP Rainy day,1.86,0.00,GBP,COMPLETED,293.96
TRANSFER,Deposit,2022-04-16 13:24:26,2022-04-16 13:24:26,To GBP Rainy day,0.03,0.00,GBP,COMPLETED,293.99
TRANSFER,Deposit,2022-04-16 13:25:44,2022-04-16 13:25:44,To GBP Rainy day,0.90,0.00,GBP,COMPLETED,294.89
TRANSFER,Deposit,2022-04-16 15:13:38,2022-04-16 15:13:38,To GBP Rainy day,2.73,0.00,GBP,COMPLETED,297.62
TRANSFER,Deposit,2022-04-16 17:28:33,2022-04-16 17:28:33,To GBP Rainy day,0.60,0.00,GBP,COMPLETED,298.22
TRANSFER,Deposit,2022-04-16 17:39:20,2022-04-16 17:39:20,To GBP Rainy day,3.00,0.00,GBP,COMPLETED,301.22
TRANSFER,Deposit,2022-04-17 01:30:39,2022-04-17 01:30:39,To GBP Rainy day,0.90,0.00,GBP,COMPLETED,302.12
TRANSFER,Deposit,2022-04-17 07:05:15,2022-04-17 07:05:15,To GBP Rainy day,5.00,0.00,GBP,COMPLETED,307.12
TRANSFER,Deposit,2022-04-17 13:29:33,2022-04-17 13:29:33,To GBP Rainy day,1.20,0.00,GBP,COMPLETED,308.32
TRANSFER,Deposit,2022-04-17 15:29:40,2022-04-17 15:29:40,To GBP Rainy day,3.00,0.00,GBP,COMPLETED,311.32
TRANSFER,Deposit,2022-04-17 15:37:34,2022-04-17 15:37:34,To GBP Rainy day,0.90,0.00,GBP,COMPLETED,312.22
TRANSFER,Deposit,2022-04-17 18:53:52,2022-04-17 18:53:52,To GBP Rainy day,3.00,0.00,GBP,COMPLETED,315.22
TRANSFER,Deposit,2022-04-17 20:10:57,2022-04-17 20:10:57,To GBP Rainy day,3.00,0.00,GBP,COMPLETED,318.22
TRANSFER,Deposit,2022-04-17 20:17:14,2022-04-17 20:17:14,To GBP Rainy day,1.50,0.00,GBP,COMPLETED,319.72
TRANSFER,Deposit,2022-04-17 20:17:39,2022-04-17 20:17:39,To GBP Rainy day,1.50,0.00,GBP,COMPLETED,321.22
TRANSFER,Deposit,2022-04-17 23:34:51,2022-04-17 23:34:51,To GBP Rainy day,0.03,0.00,GBP,COMPLETED,321.25
TRANSFER,Deposit,2022-04-18 01:17:23,2022-04-18 01:17:23,To GBP Rainy day,2.40,0.00,GBP,COMPLETED,323.65
TRANSFER,Deposit,2022-04-18 07:21:02,2022-04-18 07:21:02,To GBP Rainy day,5.00,0.00,GBP,COMPLETED,328.65
TRANSFER,Deposit,2022-04-18 13:51:42,2022-04-18 13:51:42,To GBP Rainy day,0.93,0.00,GBP,COMPLETED,329.58
TRANSFER,Deposit,2022-04-18 13:54:14,2022-04-18 13:54:14,To GBP Rainy day,3.00,0.00,GBP,COMPLETED,332.58
TRANSFER,Deposit,2022-04-18 20:52:09,2022-04-18 20:52:09,To GBP Rainy day,3.00,0.00,GBP,COMPLETED,335.58
TRANSFER,Deposit,2022-04-18 22:09:09,2022-04-18 22:09:09,To GBP Rainy day,2.07,0.00,GBP,COMPLETED,337.65
TRANSFER,Deposit,2022-04-19 01:21:15,2022-04-19 01:21:15,To GBP Rainy day,2.10,0.00,GBP,COMPLETED,339.75
TRANSFER,Deposit,2022-04-19 07:04:52,2022-04-19 07:04:52,To GBP Rainy day,5.00,0.00,GBP,COMPLETED,344.75
TRANSFER,Deposit,2022-04-19 07:55:30,2022-04-19 07:55:30,To GBP Rainy day,2.40,0.00,GBP,COMPLETED,347.15
TRANSFER,Deposit,2022-04-19 10:40:54,2022-04-19 10:40:54,To GBP Rainy day,1.20,0.00,GBP,COMPLETED,348.35
TRANSFER,Deposit,2022-04-19 13:43:19,2022-04-19 13:43:19,To GBP Rainy day,2.55,0.00,GBP,COMPLETED,350.90
TRANSFER,Deposit,2022-04-19 14:16:47,2022-04-19 14:16:47,To GBP Education,50000.00,0.00,GBP,COMPLETED,50350.90
TRANSFER,Deposit,2022-04-19 14:18:18,2022-04-19 14:18:18,To GBP Savings,48000.00,0.00,GBP,COMPLETED,98350.90
TRANSFER,Deposit,2022-04-19 16:16:01,2022-04-19 16:16:01,To GBP Rainy day,3.00,0.00,GBP,COMPLETED,98353.90
TRANSFER,Deposit,2022-04-19 16:28:04,2022-04-19 16:28:04,To GBP Rainy day,3.00,0.00,GBP,COMPLETED,98356.90
TRANSFER,Deposit,2022-04-19 16:43:02,2022-04-19 16:43:02,To GBP Rainy day,2.40,0.00,GBP,COMPLETED,98359.30
TRANSFER,Deposit,2022-04-19 18:17:05,2022-04-19 18:17:05,To GBP Rainy day,1.20,0.00,GBP,COMPLETED,98360.50
TRANSFER,Deposit,2022-04-19 20:02:44,2022-04-19 20:02:44,To GBP Rainy day,2.25,0.00,GBP,COMPLETED,98362.75
TRANSFER,Deposit,2022-04-19 20:19:21,2022-04-19 20:19:21,To GBP Rainy day,0.75,0.00,GBP,COMPLETED,98363.50
TRANSFER,Deposit,2022-04-19 22:56:16,2022-04-19 22:56:16,To GBP Rainy day,3.00,0.00,GBP,COMPLETED,98366.50
TRANSFER,Deposit,2022-04-20 01:37:20,2022-04-20 01:37:20,To GBP Rainy day,0.90,0.00,GBP,COMPLETED,98367.40
TRANSFER,Deposit,2022-04-20 07:05:25,2022-04-20 07:05:25,To GBP Rainy day,5.00,0.00,GBP,COMPLETED,98372.40
TRANSFER,Deposit,2022-04-20 09:44:24,2022-04-20 09:44:24,To GBP Rainy day,1.95,0.00,GBP,COMPLETED,98374.35
TRANSFER,Deposit,2022-04-20 12:33:23,2022-04-20 12:33:23,To GBP Rainy day,1.95,0.00,GBP,COMPLETED,98376.30
TRANSFER,Deposit,2022-04-20 18:05:23,2022-04-20 18:05:23,To GBP Rainy day,0.66,0.00,GBP,COMPLETED,98376.96
TRANSFER,Deposit,2022-04-20 21:34:32,2022-04-20 21:34:32,To GBP Rainy day,0.63,0.00,GBP,COMPLETED,98377.59
TRANSFER,Deposit,2022-04-21 01:42:27,2022-04-21 01:42:27,To GBP Rainy day,0.60,0.00,GBP,COMPLETED,98378.19
TRANSFER,Deposit,2022-04-21 07:06:03,2022-04-21 07:06:03,To GBP Rainy day,5.00,0.00,GBP,COMPLETED,98383.19
TRANSFER,Deposit,2022-04-21 11:22:02,2022-04-21 11:22:02,To GBP Rainy day,1.95,0.00,GBP,COMPLETED,98385.14
TRANSFER,Deposit,2022-04-21 17:31:56,2022-04-21 17:31:56,To GBP Rainy day,2.67,0.00,GBP,COMPLETED,98387.81
TRANSFER,Deposit,2022-04-21 17:36:01,2022-04-21 17:36:01,To GBP Rainy day,3.00,0.00,GBP,COMPLETED,98390.81
TRANSFER,Deposit,2022-04-21 17:49:39,2022-04-21 17:49:39,To GBP Rainy day,3.00,0.00,GBP,COMPLETED,98393.81
TRANSFER,Deposit,2022-04-21 19:37:50,2022-04-21 19:37:50,To GBP Rainy day,2.64,0.00,GBP,COMPLETED,98396.45
TRANSFER,Deposit,2022-04-22 01:41:15,2022-04-22 01:41:15,To GBP Rainy day,0.15,0.00,GBP,COMPLETED,98396.60
TRANSFER,Deposit,2022-04-22 03:18:09,2022-04-22 03:18:09,To GBP Rainy day,0.03,0.00,GBP,COMPLETED,98396.63
TRANSFER,Deposit,2022-04-22 07:08:01,2022-04-22 07:08:01,To GBP Rainy day,5.00,0.00,GBP,COMPLETED,98401.63
TRANSFER,Deposit,2022-04-22 10:02:40,2022-04-22 10:02:40,To GBP Rainy day,1.95,0.00,GBP,COMPLETED,98403.58
TRANSFER,Deposit,2022-04-22 11:40:03,2022-04-22 11:40:03,To GBP Rainy day,1.65,0.00,GBP,COMPLETED,98405.23
TRANSFER,Deposit,2022-04-22 14:59:16,2022-04-22 14:59:16,To GBP Rainy day,3.00,0.00,GBP,COMPLETED,98408.23
TRANSFER,Deposit,2022-04-22 17:21:07,2022-04-22 17:21:07,To GBP Rainy day,0.15,0.00,GBP,COMPLETED,98408.38
TRANSFER,Deposit,2022-04-22 17:24:07,2022-04-22 17:24:07,To GBP Rainy day,1.53,0.00,GBP,COMPLETED,98409.91
TRANSFER,Deposit,2022-04-22 17:29:28,2022-04-22 17:29:28,To GBP Rainy day,3.00,0.00,GBP,COMPLETED,98412.91
TRANSFER,Deposit,2022-04-22 18:02:03,2022-04-22 18:02:03,To GBP Rainy day,1.80,0.00,GBP,COMPLETED,98414.71
TRANSFER,Deposit,2022-04-22 22:52:23,2022-04-22 22:52:23,To GBP Rainy day,3.00,0.00,GBP,COMPLETED,98417.71
TRANSFER,Deposit,2022-04-23 07:05:16,2022-04-23 07:05:16,To GBP Rainy day,5.00,0.00,GBP,COMPLETED,98422.71
TRANSFER,Deposit,2022-04-23 16:33:35,2022-04-23 16:33:35,To GBP Rainy day,1.53,0.00,GBP,COMPLETED,98424.24
TRANSFER,Deposit,2022-04-23 19:05:50,2022-04-23 19:05:50,To GBP Rainy day,2.85,0.00,GBP,COMPLETED,98427.09
TRANSFER,Deposit,2022-04-23 19:25:19,2022-04-23 19:25:19,To GBP Rainy day,2.10,0.00,GBP,COMPLETED,98429.19
TRANSFER,Deposit,2022-04-23 19:46:24,2022-04-23 19:46:24,To GBP Rainy day,3.00,0.00,GBP,COMPLETED,98432.19
TRANSFER,Deposit,2022-04-23 20:27:31,2022-04-23 20:27:31,To GBP Rainy day,0.09,0.00,GBP,COMPLETED,98432.28
TRANSFER,Deposit,2022-04-24 01:34:33,2022-04-24 01:34:33,To GBP Rainy day,2.40,0.00,GBP,COMPLETED,98434.68
TRANSFER,Deposit,2022-04-24 07:05:14,2022-04-24 07:05:14,To GBP Rainy day,5.00,0.00,GBP,COMPLETED,98439.68
TRANSFER,Deposit,2022-04-24 15:30:37,2022-04-24 15:30:37,To GBP Rainy day,1.80,0.00,GBP,COMPLETED,98441.48
TRANSFER,Deposit,2022-04-24 15:52:46,2022-04-24 15:52:46,To GBP Rainy day,0.15,0.00,GBP,COMPLETED,98441.63
TRANSFER,Deposit,2022-04-25 01:20:01,2022-04-25 01:20:01,To GBP Rainy day,1.20,0.00,GBP,COMPLETED,98442.83
TRANSFER,Deposit,2022-04-25 07:21:32,2022-04-25 07:21:32,To GBP Rainy day,5.00,0.00,GBP,COMPLETED,98447.83
TRANSFER,Deposit,2022-04-25 08:47:19,2022-04-25 08:47:19,To GBP Rainy day,2.85,0.00,GBP,COMPLETED,98450.68
TRANSFER,Deposit,2022-04-25 08:48:22,2022-04-25 08:48:22,To GBP Rainy day,1.95,0.00,GBP,COMPLETED,98452.63
TRANSFER,Deposit,2022-04-25 08:50:13,2022-04-25 08:50:13,To GBP Rainy day,0.75,0.00,GBP,COMPLETED,98453.38
TRANSFER,Deposit,2022-04-25 08:54:35,2022-04-25 08:54:35,To GBP Rainy day,1.95,0.00,GBP,COMPLETED,98455.33
TRANSFER,Deposit,2022-04-25 12:00:41,2022-04-25 12:00:41,To GBP Rainy day,3.00,0.00,GBP,COMPLETED,98458.33
TRANSFER,Deposit,2022-04-25 17:52:30,2022-04-25 17:52:30,To GBP Rainy day,1.50,0.00,GBP,COMPLETED,98459.83
TRANSFER,Deposit,2022-04-25 17:55:04,2022-04-25 17:55:04,To GBP Rainy day,0.03,0.00,GBP,COMPLETED,98459.86
TRANSFER,Deposit,2022-04-25 18:02:07,2022-04-25 18:02:07,To GBP Rainy day,3.00,0.00,GBP,COMPLETED,98462.86
TRANSFER,Deposit,2022-04-25 18:12:43,2022-04-25 18:12:43,To GBP Rainy day,3.00,0.00,GBP,COMPLETED,98465.86
TRANSFER,Deposit,2022-04-25 22:15:47,2022-04-25 22:15:47,To GBP Rainy day,2.40,0.00,GBP,COMPLETED,98468.26
TRANSFER,Deposit,2022-04-26 01:34:42,2022-04-26 01:34:42,To GBP Rainy day,2.40,0.00,GBP,COMPLETED,98470.66
TRANSFER,Deposit,2022-04-26 07:05:14,2022-04-26 07:05:14,To GBP Rainy day,5.00,0.00,GBP,COMPLETED,98475.66
TRANSFER,Deposit,2022-04-26 10:35:01,2022-04-26 10:35:01,To GBP Rainy day,1.95,0.00,GBP,COMPLETED,98477.61
TRANSFER,Deposit,2022-04-26 12:36:35,2022-04-26 12:36:35,To GBP Rainy day,1.95,0.00,GBP,COMPLETED,98479.56
TRANSFER,Deposit,2022-04-26 13:39:38,2022-04-26 13:39:38,To GBP Rainy day,3.00,0.00,GBP,COMPLETED,98482.56
TRANSFER,Deposit,2022-04-26 20:44:02,2022-04-26 20:44:02,To GBP Rainy day,1.65,0.00,GBP,COMPLETED,98484.21
TRANSFER,Deposit,2022-04-27 07:05:25,2022-04-27 07:05:25,To GBP Rainy day,5.00,0.00,GBP,COMPLETED,98489.21
TRANSFER,Deposit,2022-04-27 07:52:13,2022-04-27 07:52:13,To GBP Savings,2000.00,0.00,GBP,COMPLETED,100489.21
TRANSFER,Deposit,2022-04-27 10:19:03,2022-04-27 10:19:03,To GBP Rainy day,1.95,0.00,GBP,COMPLETED,100491.16
TRANSFER,Deposit,2022-04-27 11:50:07,2022-04-27 11:50:07,To GBP Rainy day,1.74,0.00,GBP,COMPLETED,100492.90
TRANSFER,Deposit,2022-04-27 14:21:16,2022-04-27 14:21:16,To GBP Rainy day,1.05,0.00,GBP,COMPLETED,100493.95
TRANSFER,Deposit,2022-04-27 14:50:10,2022-04-27 14:50:10,To GBP Rainy day,2.25,0.00,GBP,COMPLETED,100496.20
TRANSFER,Deposit,2022-04-27 15:46:38,2022-04-27 15:46:38,To GBP Rainy day,1.50,0.00,GBP,COMPLETED,100497.70
TRANSFER,Deposit,2022-04-27 18:29:03,2022-04-27 18:29:03,To GBP Rainy day,1.20,0.00,GBP,COMPLETED,100498.90
TRANSFER,Deposit,2022-04-27 21:26:39,2022-04-27 21:26:39,To GBP Rainy day,1.53,0.00,GBP,COMPLETED,100500.43
TRANSFER,Deposit,2022-04-27 21:30:31,2022-04-27 21:30:31,To GBP Rainy day,0.03,0.00,GBP,COMPLETED,100500.46
TRANSFER,Deposit,2022-04-27 21:32:54,2022-04-27 21:32:54,To GBP Rainy day,0.03,0.00,GBP,COMPLETED,100500.49
TRANSFER,Deposit,2022-04-27 21:34:19,2022-04-27 21:34:19,To GBP Rainy day,1.53,0.00,GBP,COMPLETED,100502.02
TRANSFER,Deposit,2022-04-27 21:36:57,2022-04-27 21:36:57,To GBP Rainy day,0.03,0.00,GBP,COMPLETED,100502.05
TRANSFER,Deposit,2022-04-28 01:41:39,2022-04-28 01:41:39,To GBP Rainy day,2.40,0.00,GBP,COMPLETED,100504.45
TRANSFER,Deposit,2022-04-28 07:06:34,2022-04-28 07:06:34,To GBP Rainy day,5.00,0.00,GBP,COMPLETED,100509.45
TRANSFER,Deposit,2022-04-28 10:07:39,2022-04-28 10:07:39,To GBP Rainy day,1.95,0.00,GBP,COMPLETED,100511.40
TRANSFER,Deposit,2022-04-28 11:40:57,2022-04-28 11:40:57,To GBP Rainy day,1.95,0.00,GBP,COMPLETED,100513.35
TRANSFER,Deposit,2022-04-28 14:14:55,2022-04-28 14:14:55,To GBP Rainy day,0.21,0.00,GBP,COMPLETED,100513.56
TRANSFER,Deposit,2022-04-28 14:32:00,2022-04-28 14:32:00,To GBP Rainy day,2.40,0.00,GBP,COMPLETED,100515.96
TRANSFER,Deposit,2022-04-28 18:31:29,2022-04-28 18:31:29,To GBP Rainy day,0.51,0.00,GBP,COMPLETED,100516.47
TRANSFER,Deposit,2022-04-28 18:45:03,2022-04-28 18:45:03,To GBP Rainy day,1.50,0.00,GBP,COMPLETED,100517.97
TRANSFER,Deposit,2022-04-29 07:08:14,2022-04-29 07:08:14,To GBP Rainy day,5.00,0.00,GBP,COMPLETED,100522.97
TRANSFER,Deposit,2022-04-29 09:30:30,2022-04-29 09:30:30,To GBP Rainy day,0.33,0.00,GBP,COMPLETED,100523.30
TRANSFER,Deposit,2022-04-29 11:12:03,2022-04-29 11:12:03,To GBP Rainy day,1.95,0.00,GBP,COMPLETED,100525.25
TRANSFER,Deposit,2022-04-29 13:32:28,2022-04-29 13:32:28,To GBP Rainy day,0.03,0.00,GBP,COMPLETED,100525.28
TRANSFER,Deposit,2022-04-29 13:45:18,2022-04-29 13:45:18,To GBP Rainy day,1.50,0.00,GBP,COMPLETED,100526.78
TRANSFER,Deposit,2022-04-29 14:27:48,2022-04-29 14:27:48,To GBP Rainy day,1.50,0.00,GBP,COMPLETED,100528.28
TRANSFER,Deposit,2022-04-29 18:05:59,2022-04-29 18:05:59,To GBP Rainy day,3.00,0.00,GBP,COMPLETED,100531.28
TRANSFER,Deposit,2022-04-29 18:32:14,2022-04-29 18:32:14,To GBP Rainy day,3.00,0.00,GBP,COMPLETED,100534.28
TRANSFER,Deposit,2022-04-30 03:18:26,2022-04-30 03:18:26,To GBP Rainy day,3.00,0.00,GBP,COMPLETED,100537.28
TRANSFER,Deposit,2022-04-30 06:42:11,2022-04-30 06:42:11,To GBP Rainy day,0.03,0.00,GBP,COMPLETED,100537.31
TRANSFER,Deposit,2022-04-30 07:07:09,2022-04-30 07:07:09,To GBP Rainy day,5.00,0.00,GBP,COMPLETED,100542.31
TRANSFER,Deposit,2022-04-30 09:39:04,2022-04-30 09:39:04,To GBP Savings,5000.00,0.00,GBP,COMPLETED,105542.31
TRANSFER,Deposit,2022-04-30 10:21:56,2022-04-30 10:21:56,To GBP Rainy day,3.00,0.00,GBP,COMPLETED,105545.31
TRANSFER,Deposit,2022-04-30 12:55:28,2022-04-30 12:55:28,To GBP Rainy day,1.50,0.00,GBP,COMPLETED,105546.81
TRANSFER,Deposit,2022-04-30 13:39:13,2022-04-30 13:39:13,To GBP Rainy day,2.55,0.00,GBP,COMPLETED,105549.36
TRANSFER,Deposit,2022-04-30 15:45:49,2022-04-30 15:45:49,To GBP Rainy day,3.00,0.00,GBP,COMPLETED,105552.36
TRANSFER,Deposit,2022-04-30 18:53:15,2022-04-30 18:53:15,To GBP Rainy day,0.09,0.00,GBP,COMPLETED,105552.45
TRANSFER,Deposit,2022-05-01 01:32:36,2022-05-01 01:32:36,To GBP Rainy day,0.60,0.00,GBP,COMPLETED,105553.05
TRANSFER,Deposit,2022-05-01 07:10:05,2022-05-01 07:10:05,To GBP Rainy day,5.00,0.00,GBP,COMPLETED,105558.05
TRANSFER,Deposit,2022-05-01 18:01:29,2022-05-01 18:01:29,To GBP Rainy day,3.00,0.00,GBP,COMPLETED,105561.05
TRANSFER,Deposit,2022-05-01 19:30:16,2022-05-01 19:30:16,To GBP Rainy day,3.00,0.00,GBP,COMPLETED,105564.05
TRANSFER,Deposit,2022-05-01 19:50:47,2022-05-01 19:50:47,To GBP Rainy day,3.00,0.00,GBP,COMPLETED,105567.05
TRANSFER,Deposit,2022-05-01 19:56:22,2022-05-01 19:56:22,To GBP Rainy day,2.40,0.00,GBP,COMPLETED,105569.45
TRANSFER,Deposit,2022-05-01 20:10:04,2022-05-01 20:10:04,To GBP Rainy day,1.35,0.00,GBP,COMPLETED,105570.80
TRANSFER,Deposit,2022-05-01 20:26:35,2022-05-01 20:26:35,To GBP Rainy day,1.35,0.00,GBP,COMPLETED,105572.15
TRANSFER,Deposit,2022-05-01 21:01:17,2022-05-01 21:01:17,To GBP Rainy day,1.35,0.00,GBP,COMPLETED,105573.50
TRANSFER,Deposit,2022-05-01 22:18:52,2022-05-01 22:18:52,To GBP Rainy day,0.15,0.00,GBP,COMPLETED,105573.65
TRANSFER,Deposit,2022-05-02 01:23:54,2022-05-02 01:23:54,To GBP Rainy day,1.20,0.00,GBP,COMPLETED,105574.85
TRANSFER,Deposit,2022-05-02 07:22:04,2022-05-02 07:22:04,To GBP Rainy day,5.00,0.00,GBP,COMPLETED,105579.85
TRANSFER,Deposit,2022-05-02 09:46:24,2022-05-02 09:46:24,To GBP Rainy day,0.30,0.00,GBP,COMPLETED,105580.15
TRANSFER,Deposit,2022-05-02 13:51:03,2022-05-02 13:51:03,To GBP Rainy day,0.60,0.00,GBP,COMPLETED,105580.75
TRANSFER,Deposit,2022-05-02 15:52:57,2022-05-02 15:52:57,To GBP Rainy day,1.80,0.00,GBP,COMPLETED,105582.55
TRANSFER,Deposit,2022-05-02 18:11:23,2022-05-02 18:11:23,To GBP Rainy day,1.35,0.00,GBP,COMPLETED,105583.90
TRANSFER,Deposit,2022-05-03 01:20:55,2022-05-03 01:20:55,To GBP Rainy day,0.30,0.00,GBP,COMPLETED,105584.20
TRANSFER,Deposit,2022-05-03 07:05:21,2022-05-03 07:05:21,To GBP Rainy day,5.00,0.00,GBP,COMPLETED,105589.20
TRANSFER,Deposit,2022-05-03 10:21:17,2022-05-03 10:21:17,To GBP Rainy day,1.95,0.00,GBP,COMPLETED,105591.15
TRANSFER,Deposit,2022-05-03 13:37:47,2022-05-03 13:37:47,To GBP Rainy day,1.95,0.00,GBP,COMPLETED,105593.10
TRANSFER,Deposit,2022-05-03 15:14:35,2022-05-03 15:14:35,To GBP Rainy day,3.00,0.00,GBP,COMPLETED,105596.10
TRANSFER,Deposit,2022-05-03 18:30:41,2022-05-03 18:30:41,To GBP Rainy day,3.00,0.00,GBP,COMPLETED,105599.10
TRANSFER,Deposit,2022-05-03 18:43:03,2022-05-03 18:43:03,To GBP Rainy day,1.95,0.00,GBP,COMPLETED,105601.05
TRANSFER,Deposit,2022-05-03 19:16:29,2022-05-03 19:16:29,To GBP Rainy day,3.00,0.00,GBP,COMPLETED,105604.05
TRANSFER,Deposit,2022-05-03 19:38:36,2022-05-03 19:38:36,To GBP Rainy day,0.15,0.00,GBP,COMPLETED,105604.20
TRANSFER,Deposit,2022-05-03 20:54:20,2022-05-03 20:54:20,To GBP Rainy day,3.00,0.00,GBP,COMPLETED,105607.20
TRANSFER,Deposit,2022-05-03 21:18:05,2022-05-03 21:18:05,To GBP Rainy day,1.50,0.00,GBP,COMPLETED,105608.70
TRANSFER,Deposit,2022-05-03 21:48:12,2022-05-03 21:48:12,To GBP Rainy day,1.50,0.00,GBP,COMPLETED,105610.20
TRANSFER,Deposit,2022-05-03 22:15:05,2022-05-03 22:15:05,To GBP Rainy day,0.36,0.00,GBP,COMPLETED,105610.56
TRANSFER,Deposit,2022-05-03 22:52:00,2022-05-03 22:52:00,To GBP Rainy day,2.55,0.00,GBP,COMPLETED,105613.11
TRANSFER,Deposit,2022-05-04 01:38:28,2022-05-04 01:38:28,To GBP Rainy day,2.40,0.00,GBP,COMPLETED,105615.51
TRANSFER,Deposit,2022-05-04 07:05:24,2022-05-04 07:05:24,To GBP Rainy day,5.00,0.00,GBP,COMPLETED,105620.51
TRANSFER,Deposit,2022-05-04 11:41:44,2022-05-04 11:41:44,To GBP Rainy day,3.00,0.00,GBP,COMPLETED,105623.51
TRANSFER,Deposit,2022-05-04 13:09:10,2022-05-04 13:09:10,To GBP Rainy day,1.80,0.00,GBP,COMPLETED,105625.31
TRANSFER,Deposit,2022-05-04 18:55:30,2022-05-04 18:55:30,To GBP Rainy day,1.05,0.00,GBP,COMPLETED,105626.36
TRANSFER,Deposit,2022-05-04 19:23:22,2022-05-04 19:23:22,To GBP Rainy day,1.80,0.00,GBP,COMPLETED,105628.16
TRANSFER,Deposit,2022-05-04 19:54:43,2022-05-04 19:54:43,To GBP Rainy day,2.31,0.00,GBP,COMPLETED,105630.47
TRANSFER,Deposit,2022-05-05 07:06:53,2022-05-05 07:06:53,To GBP Rainy day,5.00,0.00,GBP,COMPLETED,105635.47
TRANSFER,Deposit,2022-05-05 09:38:43,2022-05-05 09:38:43,To GBP Rainy day,1.95,0.00,GBP,COMPLETED,105637.42
TRANSFER,Deposit,2022-05-05 11:50:26,2022-05-05 11:50:26,To GBP Rainy day,1.95,0.00,GBP,COMPLETED,105639.37
TRANSFER,Deposit,2022-05-05 13:22:46,2022-05-05 13:22:46,To GBP Rainy day,0.75,0.00,GBP,COMPLETED,105640.12
TRANSFER,Deposit,2022-05-05 15:27:26,2022-05-05 15:27:26,To GBP Rainy day,0.90,0.00,GBP,COMPLETED,105641.02
TRANSFER,Deposit,2022-05-05 15:41:31,2022-05-05 15:41:31,To GBP Rainy day,2.10,0.00,GBP,COMPLETED,105643.12
TRANSFER,Deposit,2022-05-06 01:46:06,2022-05-06 01:46:06,To GBP Rainy day,0.60,0.00,GBP,COMPLETED,105643.72
TRANSFER,Deposit,2022-05-06 07:08:21,2022-05-06 07:08:21,To GBP Rainy day,5.00,0.00,GBP,COMPLETED,105648.72
TRANSFER,Deposit,2022-05-06 12:44:47,2022-05-06 12:44:47,To GBP Rainy day,0.15,0.00,GBP,COMPLETED,105648.87
TRANSFER,Deposit,2022-05-06 14:41:53,2022-05-06 14:41:53,To GBP Rainy day,0.75,0.00,GBP,COMPLETED,105649.62
TRANSFER,Deposit,2022-05-06 15:16:31,2022-05-06 15:16:31,To GBP Rainy day,1.65,0.00,GBP,COMPLETED,105651.27
TRANSFER,Deposit,2022-05-06 18:30:04,2022-05-06 18:30:04,To GBP Rainy day,1.50,0.00,GBP,COMPLETED,105652.77
TRANSFER,Deposit,2022-05-06 18:33:35,2022-05-06 18:33:35,To GBP Rainy day,1.20,0.00,GBP,COMPLETED,105653.97
TRANSFER,Deposit,2022-05-06 19:39:06,2022-05-06 19:39:06,To GBP Rainy day,2.04,0.00,GBP,COMPLETED,105656.01
TRANSFER,Deposit,2022-05-06 21:00:48,2022-05-06 21:00:48,To GBP Rainy day,0.60,0.00,GBP,COMPLETED,105656.61
TRANSFER,Deposit,2022-05-06 21:13:22,2022-05-06 21:13:22,To GBP Rainy day,1.50,0.00,GBP,COMPLETED,105658.11
TRANSFER,Deposit,2022-05-06 22:22:41,2022-05-06 22:22:41,To GBP Rainy day,1.50,0.00,GBP,COMPLETED,105659.61
TRANSFER,Deposit,2022-05-06 23:11:46,2022-05-06 23:11:46,To GBP Rainy day,0.30,0.00,GBP,COMPLETED,105659.91
TRANSFER,Deposit,2022-05-07 01:38:51,2022-05-07 01:38:51,To GBP Rainy day,0.90,0.00,GBP,COMPLETED,105660.81
TRANSFER,Deposit,2022-05-07 07:05:36,2022-05-07 07:05:36,To GBP Rainy day,5.00,0.00,GBP,COMPLETED,105665.81
TRANSFER,Deposit,2022-05-07 13:29:42,2022-05-07 13:29:42,To GBP Rainy day,2.40,0.00,GBP,COMPLETED,105668.21
TRANSFER,Deposit,2022-05-07 13:44:18,2022-05-07 13:44:18,To GBP Rainy day,2.40,0.00,GBP,COMPLETED,105670.61
TRANSFER,Deposit,2022-05-07 13:52:56,2022-05-07 13:52:56,To GBP Rainy day,1.50,0.00,GBP,COMPLETED,105672.11
TRANSFER,Deposit,2022-05-07 17:58:36,2022-05-07 17:58:36,To GBP Rainy day,0.15,0.00,GBP,COMPLETED,105672.26
TRANSFER,Deposit,2022-05-07 19:24:35,2022-05-07 19:24:35,To GBP Rainy day,2.10,0.00,GBP,COMPLETED,105674.36
TRANSFER,Deposit,2022-05-07 19:31:28,2022-05-07 19:31:28,To GBP Rainy day,0.30,0.00,GBP,COMPLETED,105674.66
TRANSFER,Deposit,2022-05-07 20:32:28,2022-05-07 20:32:28,To GBP Rainy day,1.20,0.00,GBP,COMPLETED,105675.86
TRANSFER,Deposit,2022-05-08 01:30:57,2022-05-08 01:30:57,To GBP Rainy day,0.60,0.00,GBP,COMPLETED,105676.46
TRANSFER,Deposit,2022-05-08 07:05:32,2022-05-08 07:05:32,To GBP Rainy day,5.00,0.00,GBP,COMPLETED,105681.46
TRANSFER,Deposit,2022-05-08 08:57:05,2022-05-08 08:57:05,To GBP Rainy day,0.06,0.00,GBP,COMPLETED,105681.52
TRANSFER,Deposit,2022-05-08 08:57:33,2022-05-08 08:57:33,To GBP Rainy day,1.23,0.00,GBP,COMPLETED,105682.75
TRANSFER,Deposit,2022-05-08 10:11:33,2022-05-08 10:11:33,To GBP Rainy day,3.00,0.00,GBP,COMPLETED,105685.75
TRANSFER,Deposit,2022-05-08 10:12:32,2022-05-08 10:12:32,To GBP Rainy day,3.00,0.00,GBP,COMPLETED,105688.75
TRANSFER,Deposit,2022-05-08 10:23:19,2022-05-08 10:23:19,To GBP Rainy day,1.50,0.00,GBP,COMPLETED,105690.25
TRANSFER,Deposit,2022-05-08 11:06:03,2022-05-08 11:06:03,To GBP Rainy day,0.90,0.00,GBP,COMPLETED,105691.15
TRANSFER,Deposit,2022-05-08 15:19:59,2022-05-08 15:19:59,To GBP Rainy day,1.20,0.00,GBP,COMPLETED,105692.35
TRANSFER,Deposit,2022-05-08 16:30:45,2022-05-08 16:30:45,To GBP Rainy day,2.58,0.00,GBP,COMPLETED,105694.93
TRANSFER,Deposit,2022-05-08 19:10:51,2022-05-08 19:10:51,To GBP Rainy day,0.84,0.00,GBP,COMPLETED,105695.77
TRANSFER,Deposit,2022-05-08 19:51:05,2022-05-08 19:51:05,To GBP Rainy day,1.86,0.00,GBP,COMPLETED,105697.63
TRANSFER,Deposit,2022-05-09 01:20:58,2022-05-09 01:20:58,To GBP Rainy day,1.20,0.00,GBP,COMPLETED,105698.83
TRANSFER,Deposit,2022-05-09 01:29:37,2022-05-09 01:29:37,To GBP Rainy day,1.20,0.00,GBP,COMPLETED,105700.03
TRANSFER,Deposit,2022-05-09 06:57:52,2022-05-09 06:57:52,To GBP Rainy day,2.58,0.00,GBP,COMPLETED,105702.61
TRANSFER,Deposit,2022-05-09 07:03:16,2022-05-09 07:03:16,To GBP Rainy day,1.65,0.00,GBP,COMPLETED,105704.26
TRANSFER,Deposit,2022-05-09 07:21:51,2022-05-09 07:21:51,To GBP Rainy day,5.00,0.00,GBP,COMPLETED,105709.26
TRANSFER,Deposit,2022-05-09 11:45:27,2022-05-09 11:45:28,To GBP Rainy day,2.19,0.00,GBP,COMPLETED,105711.45
TRANSFER,Deposit,2022-05-09 13:22:28,2022-05-09 13:22:28,To GBP Rainy day,0.15,0.00,GBP,COMPLETED,105711.60
TRANSFER,Deposit,2022-05-09 14:24:17,2022-05-09 14:24:17,To GBP Rainy day,0.24,0.00,GBP,COMPLETED,105711.84
TRANSFER,Deposit,2022-05-09 14:27:22,2022-05-09 14:27:22,To GBP Rainy day,0.81,0.00,GBP,COMPLETED,105712.65
TRANSFER,Deposit,2022-05-09 20:17:46,2022-05-09 20:17:46,To GBP Rainy day,1.17,0.00,GBP,COMPLETED,105713.82
TRANSFER,Deposit,2022-05-09 22:38:27,2022-05-09 22:38:27,To GBP Rainy day,3.00,0.00,GBP,COMPLETED,105716.82
TRANSFER,Deposit,2022-05-10 07:05:52,2022-05-10 07:05:52,To GBP Rainy day,5.00,0.00,GBP,COMPLETED,105721.82
TRANSFER,Deposit,2022-05-10 10:04:23,2022-05-10 10:04:23,To GBP Rainy day,1.41,0.00,GBP,COMPLETED,105723.23
TRANSFER,Deposit,2022-05-10 10:21:35,2022-05-10 10:21:35,To GBP Rainy day,2.97,0.00,GBP,COMPLETED,105726.20
TRANSFER,Deposit,2022-05-10 13:25:49,2022-05-10 13:25:49,To GBP Rainy day,0.87,0.00,GBP,COMPLETED,105727.07
TRANSFER,Deposit,2022-05-10 15:37:08,2022-05-10 15:37:08,To GBP Rainy day,1.74,0.00,GBP,COMPLETED,105728.81
TRANSFER,Deposit,2022-05-10 21:54:29,2022-05-10 21:54:29,To GBP Rainy day,2.43,0.00,GBP,COMPLETED,105731.24
TRANSFER,Deposit,2022-05-10 22:10:56,2022-05-10 22:10:56,To GBP Rainy day,2.58,0.00,GBP,COMPLETED,105733.82
TRANSFER,Deposit,2022-05-11 06:23:19,2022-05-11 06:23:19,To GBP Rainy day,0.21,0.00,GBP,COMPLETED,105734.03
TRANSFER,Deposit,2022-05-11 07:05:27,2022-05-11 07:05:27,To GBP Rainy day,5.00,0.00,GBP,COMPLETED,105739.03
TRANSFER,Deposit,2022-05-11 10:30:23,2022-05-11 10:30:23,To GBP Rainy day,1.50,0.00,GBP,COMPLETED,105740.53
TRANSFER,Deposit,2022-05-11 11:19:55,2022-05-11 11:19:55,To GBP Rainy day,2.40,0.00,GBP,COMPLETED,105742.93
TRANSFER,Deposit,2022-05-11 12:08:41,2022-05-11 12:08:41,To GBP Rainy day,0.03,0.00,GBP,COMPLETED,105742.96
TRANSFER,Deposit,2022-05-11 12:54:06,2022-05-11 12:54:06,To GBP Rainy day,1.95,0.00,GBP,COMPLETED,105744.91
TRANSFER,Deposit,2022-05-11 14:22:13,2022-05-11 14:22:13,To GBP Rainy day,2.79,0.00,GBP,COMPLETED,105747.70
TRANSFER,Deposit,2022-05-11 14:34:29,2022-05-11 14:34:29,To GBP Rainy day,0.75,0.00,GBP,COMPLETED,105748.45
TRANSFER,Deposit,2022-05-11 17:17:35,2022-05-11 17:17:35,To GBP Rainy day,0.15,0.00,GBP,COMPLETED,105748.60
TRANSFER,Deposit,2022-05-12 01:45:13,2022-05-12 01:45:13,To GBP Rainy day,2.40,0.00,GBP,COMPLETED,105751.00
TRANSFER,Deposit,2022-05-12 07:06:17,2022-05-12 07:06:17,To GBP Rainy day,5.00,0.00,GBP,COMPLETED,105756.00
TRANSFER,Deposit,2022-05-12 09:50:57,2022-05-12 09:50:57,To GBP Rainy day,2.25,0.00,GBP,COMPLETED,105758.25
TRANSFER,Deposit,2022-05-12 10:46:52,2022-05-12 10:46:52,To GBP Rainy day,3.00,0.00,GBP,COMPLETED,105761.25
TRANSFER,Deposit,2022-05-12 10:48:52,2022-05-12 10:48:52,To GBP Rainy day,1.95,0.00,GBP,COMPLETED,105763.20
TRANSFER,Deposit,2022-05-12 11:40:54,2022-05-12 11:40:54,To GBP Rainy day,0.75,0.00,GBP,COMPLETED,105763.95
TRANSFER,Deposit,2022-05-12 13:55:21,2022-05-12 13:55:21,To GBP Rainy day,1.95,0.00,GBP,COMPLETED,105765.90
TRANSFER,Deposit,2022-05-12 17:21:20,2022-05-12 17:21:20,To GBP Rainy day,3.00,0.00,GBP,COMPLETED,105768.90
TRANSFER,Deposit,2022-05-12 17:30:37,2022-05-12 17:30:37,To GBP Rainy day,0.03,0.00,GBP,COMPLETED,105768.93
TRANSFER,Deposit,2022-05-12 17:53:46,2022-05-12 17:53:46,To GBP Rainy day,0.57,0.00,GBP,COMPLETED,105769.50
TRANSFER,Deposit,2022-05-13 07:08:12,2022-05-13 07:08:12,To GBP Rainy day,5.00,0.00,GBP,COMPLETED,105774.50
TRANSFER,Deposit,2022-05-13 09:47:57,2022-05-13 09:47:57,To GBP Rainy day,1.95,0.00,GBP,COMPLETED,105776.45
TRANSFER,Deposit,2022-05-13 11:40:00,2022-05-13 11:40:00,To GBP Rainy day,2.40,0.00,GBP,COMPLETED,105778.85
TRANSFER,Deposit,2022-05-13 18:17:39,2022-05-13 18:17:39,To GBP Rainy day,0.69,0.00,GBP,COMPLETED,105779.54
TRANSFER,Deposit,2022-05-13 18:21:40,2022-05-13 18:21:40,To GBP Rainy day,1.20,0.00,GBP,COMPLETED,105780.74
TRANSFER,Deposit,2022-05-13 18:31:51,2022-05-13 18:31:51,To GBP Rainy day,3.00,0.00,GBP,COMPLETED,105783.74
TRANSFER,Deposit,2022-05-13 18:54:30,2022-05-13 18:54:30,To GBP Rainy day,1.50,0.00,GBP,COMPLETED,105785.24
TRANSFER,Deposit,2022-05-13 19:38:32,2022-05-13 19:38:32,To GBP Rainy day,1.50,0.00,GBP,COMPLETED,105786.74
TRANSFER,Deposit,2022-05-13 21:06:27,2022-05-13 21:06:27,To GBP Rainy day,2.07,0.00,GBP,COMPLETED,105788.81
TRANSFER,Deposit,2022-05-14 07:05:25,2022-05-14 07:05:25,To GBP Rainy day,5.00,0.00,GBP,COMPLETED,105793.81
TRANSFER,Deposit,2022-05-14 20:33:07,2022-05-14 20:33:07,To GBP Rainy day,3.00,0.00,GBP,COMPLETED,105796.81
TRANSFER,Deposit,2022-05-14 22:13:51,2022-05-14 22:13:51,To GBP Rainy day,3.00,0.00,GBP,COMPLETED,105799.81
TRANSFER,Deposit,2022-05-15 07:06:01,2022-05-15 07:06:01,To GBP Rainy day,5.00,0.00,GBP,COMPLETED,105804.81
TRANSFER,Deposit,2022-05-15 08:38:01,2022-05-15 08:38:01,To GBP Rainy day,3.00,0.00,GBP,COMPLETED,105807.81
TRANSFER,Deposit,2022-05-15 14:14:14,2022-05-15 14:14:14,To GBP Rainy day,1.35,0.00,GBP,COMPLETED,105809.16
TRANSFER,Deposit,2022-05-15 17:33:30,2022-05-15 17:33:30,To GBP Rainy day,2.85,0.00,GBP,COMPLETED,105812.01
TRANSFER,Deposit,2022-05-16 01:18:28,2022-05-16 01:18:28,To GBP Rainy day,1.20,0.00,GBP,COMPLETED,105813.21
TRANSFER,Deposit,2022-05-16 07:22:11,2022-05-16 07:22:11,To GBP Rainy day,5.00,0.00,GBP,COMPLETED,105818.21
TRANSFER,Deposit,2022-05-16 09:34:50,2022-05-16 09:34:50,To GBP Rainy day,1.95,0.00,GBP,COMPLETED,105820.16
TRANSFER,Deposit,2022-05-16 10:36:21,2022-05-16 10:36:21,To GBP Rainy day,1.95,0.00,GBP,COMPLETED,105822.11
TRANSFER,Deposit,2022-05-16 15:55:16,2022-05-16 15:55:16,To GBP Rainy day,1.80,0.00,GBP,COMPLETED,105823.91
TRANSFER,Deposit,2022-05-16 18:26:20,2022-05-16 18:26:20,To GBP Rainy day,3.00,0.00,GBP,COMPLETED,105826.91
TRANSFER,Deposit,2022-05-16 18:48:53,2022-05-16 18:48:53,To GBP Rainy day,1.20,0.00,GBP,COMPLETED,105828.11
TRANSFER,Deposit,2022-05-17 07:05:04,2022-05-17 07:05:04,To GBP Rainy day,5.00,0.00,GBP,COMPLETED,105833.11
TRANSFER,Deposit,2022-05-17 09:54:45,2022-05-17 09:54:45,To GBP Rainy day,1.95,0.00,GBP,COMPLETED,105835.06
TRANSFER,Deposit,2022-05-17 18:20:25,2022-05-17 18:20:25,To GBP Rainy day,0.06,0.00,GBP,COMPLETED,105835.12
TRANSFER,Deposit,2022-05-17 21:04:19,2022-05-17 21:04:19,To GBP Rainy day,0.69,0.00,GBP,COMPLETED,105835.81
TRANSFER,Deposit,2022-05-18 01:45:48,2022-05-18 01:45:48,To GBP Rainy day,1.50,0.00,GBP,COMPLETED,105837.31
TRANSFER,Deposit,2022-05-18 07:05:18,2022-05-18 07:05:18,To GBP Rainy day,5.00,0.00,GBP,COMPLETED,105842.31
TRANSFER,Deposit,2022-05-18 09:43:00,2022-05-18 09:43:00,To GBP Rainy day,0.45,0.00,GBP,COMPLETED,105842.76
TRANSFER,Deposit,2022-05-18 09:46:26,2022-05-18 09:46:26,To GBP Rainy day,1.50,0.00,GBP,COMPLETED,105844.26
TRANSFER,Deposit,2022-05-18 11:14:25,2022-05-18 11:14:25,To GBP Rainy day,1.95,0.00,GBP,COMPLETED,105846.21
TRANSFER,Deposit,2022-05-18 15:23:39,2022-05-18 15:23:39,To GBP Rainy day,1.65,0.00,GBP,COMPLETED,105847.86
TRANSFER,Deposit,2022-05-18 18:41:56,2022-05-18 18:41:56,To GBP Rainy day,2.34,0.00,GBP,COMPLETED,105850.20
TRANSFER,Deposit,2022-05-18 18:47:11,2022-05-18 18:47:11,To GBP Rainy day,0.03,0.00,GBP,COMPLETED,105850.23
TRANSFER,Deposit,2022-05-19 07:06:09,2022-05-19 07:06:09,To GBP Rainy day,5.00,0.00,GBP,COMPLETED,105855.23
TRANSFER,Deposit,2022-05-19 10:35:23,2022-05-19 10:35:23,To GBP Rainy day,2.10,0.00,GBP,COMPLETED,105857.33
TRANSFER,Deposit,2022-05-19 12:55:24,2022-05-19 12:55:24,To GBP Rainy day,1.95,0.00,GBP,COMPLETED,105859.28
TRANSFER,Deposit,2022-05-19 13:21:39,2022-05-19 13:21:39,To GBP Rainy day,1.50,0.00,GBP,COMPLETED,105860.78
TRANSFER,Deposit,2022-05-19 16:04:12,2022-05-19 16:04:12,To GBP Rainy day,2.94,0.00,GBP,COMPLETED,105863.72
TRANSFER,Deposit,2022-05-19 18:36:52,2022-05-19 18:36:52,To GBP Rainy day,2.10,0.00,GBP,COMPLETED,105865.82
TRANSFER,Deposit,2022-05-19 19:02:43,2022-05-19 19:02:43,To GBP Rainy day,1.20,0.00,GBP,COMPLETED,105867.02
TRANSFER,Deposit,2022-05-19 21:11:28,2022-05-19 21:11:28,To GBP Rainy day,1.98,0.00,GBP,COMPLETED,105869.00
TRANSFER,Deposit,2022-05-19 21:34:36,2022-05-19 21:34:36,To GBP Rainy day,1.98,0.00,GBP,COMPLETED,105870.98
TRANSFER,Deposit,2022-05-19 22:47:57,2022-05-19 22:47:57,To GBP Rainy day,3.00,0.00,GBP,COMPLETED,105873.98
TRANSFER,Deposit,2022-05-20 07:08:33,2022-05-20 07:08:33,To GBP Rainy day,5.00,0.00,GBP,COMPLETED,105878.98
TRANSFER,Deposit,2022-05-20 10:39:18,2022-05-20 10:39:18,To GBP Rainy day,1.95,0.00,GBP,COMPLETED,105880.93
TRANSFER,Deposit,2022-05-20 11:08:44,2022-05-20 11:08:44,To GBP Rainy day,2.43,0.00,GBP,COMPLETED,105883.36
TRANSFER,Deposit,2022-05-20 11:43:36,2022-05-20 11:43:36,To GBP Rainy day,2.70,0.00,GBP,COMPLETED,105886.06
TRANSFER,Deposit,2022-05-20 18:09:12,2022-05-20 18:09:12,To GBP Rainy day,2.70,0.00,GBP,COMPLETED,105888.76
TRANSFER,Deposit,2022-05-20 21:43:12,2022-05-20 21:43:12,To GBP Rainy day,0.03,0.00,GBP,COMPLETED,105888.79
TRANSFER,Deposit,2022-05-21 07:05:30,2022-05-21 07:05:30,To GBP Rainy day,5.00,0.00,GBP,COMPLETED,105893.79
TRANSFER,Deposit,2022-05-21 19:34:59,2022-05-21 19:34:59,To GBP Rainy day,0.15,0.00,GBP,COMPLETED,105893.94
TRANSFER,Deposit,2022-05-22 03:17:15,2022-05-22 03:17:15,To GBP Rainy day,0.03,0.00,GBP,COMPLETED,105893.97
TRANSFER,Deposit,2022-05-22 07:05:19,2022-05-22 07:05:19,To GBP Rainy day,5.00,0.00,GBP,COMPLETED,105898.97
TRANSFER,Deposit,2022-05-22 14:16:21,2022-05-22 14:16:21,To GBP Rainy day,2.25,0.00,GBP,COMPLETED,105901.22
TRANSFER,Deposit,2022-05-22 16:04:38,2022-05-22 16:04:38,To GBP Rainy day,0.90,0.00,GBP,COMPLETED,105902.12
TRANSFER,Deposit,2022-05-22 16:05:33,2022-05-22 16:05:33,To GBP Rainy day,2.40,0.00,GBP,COMPLETED,105904.52
TRANSFER,Deposit,2022-05-22 16:23:45,2022-05-22 16:23:45,To GBP Rainy day,0.30,0.00,GBP,COMPLETED,105904.82
TRANSFER,Deposit,2022-05-22 22:51:12,2022-05-22 22:51:12,To GBP Rainy day,3.00,0.00,GBP,COMPLETED,105907.82
TRANSFER,Deposit,2022-05-23 01:20:35,2022-05-23 01:20:35,To GBP Rainy day,0.45,0.00,GBP,COMPLETED,105908.27
TRANSFER,Deposit,2022-05-23 07:22:23,2022-05-23 07:22:23,To GBP Rainy day,5.00,0.00,GBP,COMPLETED,105913.27
TRANSFER,Deposit,2022-05-23 10:50:21,2022-05-23 10:50:21,To GBP Rainy day,1.95,0.00,GBP,COMPLETED,105915.22
TRANSFER,Deposit,2022-05-23 13:08:08,2022-05-23 13:08:08,To GBP Rainy day,0.15,0.00,GBP,COMPLETED,105915.37
TRANSFER,Deposit,2022-05-23 13:33:09,2022-05-23 13:33:09,To GBP Rainy day,1.50,0.00,GBP,COMPLETED,105916.87
TRANSFER,Deposit,2022-05-23 15:49:14,2022-05-23 15:49:14,To GBP Rainy day,0.15,0.00,GBP,COMPLETED,105917.02
TRANSFER,Deposit,2022-05-23 18:36:55,2022-05-23 18:36:55,To GBP Rainy day,2.46,0.00,GBP,COMPLETED,105919.48
TRANSFER,Deposit,2022-05-23 18:50:01,2022-05-23 18:50:01,To GBP Rainy day,1.50,0.00,GBP,COMPLETED,105920.98
TRANSFER,Deposit,2022-05-23 19:09:08,2022-05-23 19:09:08,To GBP Rainy day,2.70,0.00,GBP,COMPLETED,105923.68
TRANSFER,Deposit,2022-05-23 21:39:34,2022-05-23 21:39:34,To GBP Rainy day,1.83,0.00,GBP,COMPLETED,105925.51
TRANSFER,Deposit,2022-05-23 21:41:59,2022-05-23 21:41:59,To GBP Rainy day,3.00,0.00,GBP,COMPLETED,105928.51
TRANSFER,Deposit,2022-05-24 04:51:39,2022-05-24 04:51:39,To GBP Rainy day,2.70,0.00,GBP,COMPLETED,105931.21
TRANSFER,Deposit,2022-05-24 07:04:55,2022-05-24 07:04:55,To GBP Rainy day,5.00,0.00,GBP,COMPLETED,105936.21
TRANSFER,Deposit,2022-05-24 10:12:24,2022-05-24 10:12:24,To GBP Rainy day,1.95,0.00,GBP,COMPLETED,105938.16
TRANSFER,Deposit,2022-05-24 11:44:59,2022-05-24 11:44:59,To GBP Rainy day,0.90,0.00,GBP,COMPLETED,105939.06
TRANSFER,Deposit,2022-05-24 19:09:03,2022-05-24 19:09:03,To GBP Rainy day,1.20,0.00,GBP,COMPLETED,105940.26
TRANSFER,Deposit,2022-05-24 19:20:39,2022-05-24 19:20:39,To GBP Rainy day,3.00,0.00,GBP,COMPLETED,105943.26
TRANSFER,Deposit,2022-05-24 19:44:43,2022-05-24 19:44:43,To GBP Rainy day,1.20,0.00,GBP,COMPLETED,105944.46
TRANSFER,Deposit,2022-05-25 07:05:35,2022-05-25 07:05:35,To GBP Rainy day,5.00,0.00,GBP,COMPLETED,105949.46
TRANSFER,Deposit,2022-05-25 11:11:47,2022-05-25 11:11:47,To GBP Rainy day,2.10,0.00,GBP,COMPLETED,105951.56
TRANSFER,Deposit,2022-05-25 12:51:53,2022-05-25 12:51:53,To GBP Rainy day,3.00,0.00,GBP,COMPLETED,105954.56
TRANSFER,Deposit,2022-05-25 18:27:05,2022-05-25 18:27:05,To GBP Rainy day,1.05,0.00,GBP,COMPLETED,105955.61
TRANSFER,Deposit,2022-05-25 18:35:28,2022-05-25 18:35:28,To GBP Rainy day,3.00,0.00,GBP,COMPLETED,105958.61
TRANSFER,Deposit,2022-05-25 19:01:03,2022-05-25 19:01:03,To GBP Rainy day,1.20,0.00,GBP,COMPLETED,105959.81
TRANSFER,Deposit,2022-05-26 07:06:35,2022-05-26 07:06:35,To GBP Rainy day,5.00,0.00,GBP,COMPLETED,105964.81
TRANSFER,Deposit,2022-05-26 11:34:12,2022-05-26 11:34:12,To GBP Rainy day,1.95,0.00,GBP,COMPLETED,105966.76
TRANSFER,Deposit,2022-05-26 14:23:14,2022-05-26 14:23:14,To GBP Rainy day,2.70,0.00,GBP,COMPLETED,105969.46
TRANSFER,Deposit,2022-05-26 21:46:28,2022-05-26 21:46:28,To GBP Rainy day,2.10,0.00,GBP,COMPLETED,105971.56
TRANSFER,Deposit,2022-05-27 01:39:46,2022-05-27 01:39:46,To GBP Rainy day,2.40,0.00,GBP,COMPLETED,105973.96
TRANSFER,Deposit,2022-05-27 07:08:40,2022-05-27 07:08:40,To GBP Rainy day,5.00,0.00,GBP,COMPLETED,105978.96
TRANSFER,Deposit,2022-05-27 10:59:38,2022-05-27 10:59:38,To GBP Rainy day,2.10,0.00,GBP,COMPLETED,105981.06
TRANSFER,Deposit,2022-05-27 12:12:46,2022-05-27 12:12:46,To GBP Rainy day,1.95,0.00,GBP,COMPLETED,105983.01
TRANSFER,Deposit,2022-05-27 14:23:43,2022-05-27 14:23:43,To GBP Rainy day,0.90,0.00,GBP,COMPLETED,105983.91
TRANSFER,Deposit,2022-05-27 18:06:54,2022-05-27 18:06:54,To GBP Rainy day,0.90,0.00,GBP,COMPLETED,105984.81
TRANSFER,Deposit,2022-05-27 19:37:23,2022-05-27 19:37:23,To GBP Rainy day,0.60,0.00,GBP,COMPLETED,105985.41
TRANSFER,Deposit,2022-05-28 07:06:03,2022-05-28 07:06:03,To GBP Rainy day,5.00,0.00,GBP,COMPLETED,105990.41
TRANSFER,Deposit,2022-05-28 14:40:05,2022-05-28 14:40:05,To GBP Rainy day,0.06,0.00,GBP,COMPLETED,105990.47
TRANSFER,Deposit,2022-05-29 07:05:35,2022-05-29 07:05:35,To GBP Rainy day,5.00,0.00,GBP,COMPLETED,105995.47
TRANSFER,Deposit,2022-05-29 10:37:41,2022-05-29 10:37:41,To GBP,-900.00,0.00,GBP,COMPLETED,105095.47
TRANSFER,Deposit,2022-05-29 10:39:37,2022-05-29 10:39:37,To GBP,-2000.00,0.00,GBP,COMPLETED,103095.47
TRANSFER,Deposit,2022-05-29 13:30:36,2022-05-29 13:30:36,To GBP Rainy day,0.03,0.00,GBP,COMPLETED,103095.50
TRANSFER,Deposit,2022-05-29 19:55:30,2022-05-29 19:55:30,To GBP Rainy day,0.12,0.00,GBP,COMPLETED,103095.62
TRANSFER,Deposit,2022-05-29 21:33:30,2022-05-29 21:33:30,To GBP Rainy day,1.80,0.00,GBP,COMPLETED,103097.42
TRANSFER,Deposit,2022-05-30 01:19:38,2022-05-30 01:19:38,To GBP Rainy day,2.70,0.00,GBP,COMPLETED,103100.12
TRANSFER,Deposit,2022-05-30 03:08:44,2022-05-30 03:08:44,To GBP Rainy day,3.00,0.00,GBP,COMPLETED,103103.12
TRANSFER,Deposit,2022-05-30 04:07:32,2022-05-30 04:07:32,To GBP Rainy day,0.03,0.00,GBP,COMPLETED,103103.15
TRANSFER,Deposit,2022-05-30 07:23:18,2022-05-30 07:23:18,To GBP Rainy day,5.00,0.00,GBP,COMPLETED,103108.15
TRANSFER,Deposit,2022-05-30 08:19:07,2022-05-30 08:19:07,To GBP Rainy day,1.95,0.00,GBP,COMPLETED,103110.10
TRANSFER,Deposit,2022-05-30 09:45:28,2022-05-30 09:45:28,To GBP Rainy day,1.95,0.00,GBP,COMPLETED,103112.05
TRANSFER,Deposit,2022-05-30 11:42:13,2022-05-30 11:42:13,To GBP Rainy day,0.75,0.00,GBP,COMPLETED,103112.80
TRANSFER,Deposit,2022-05-30 14:40:15,2022-05-30 14:40:15,To GBP Rainy day,0.03,0.00,GBP,COMPLETED,103112.83
TRANSFER,Deposit,2022-05-30 19:16:46,2022-05-30 19:16:46,To GBP Rainy day,2.04,0.00,GBP,COMPLETED,103114.87
TRANSFER,Deposit,2022-05-31 07:05:56,2022-05-31 07:05:56,To GBP Rainy day,5.00,0.00,GBP,COMPLETED,103119.87
TRANSFER,Deposit,2022-05-31 10:15:43,2022-05-31 10:15:43,To GBP Rainy day,1.95,0.00,GBP,COMPLETED,103121.82
TRANSFER,Deposit,2022-05-31 11:32:34,2022-05-31 11:32:34,To GBP Rainy day,1.95,0.00,GBP,COMPLETED,103123.77
TRANSFER,Deposit,2022-05-31 14:53:54,2022-05-31 14:53:54,To GBP Rainy day,2.70,0.00,GBP,COMPLETED,103126.47
TRANSFER,Deposit,2022-05-31 18:07:28,2022-05-31 18:07:28,To GBP Rainy day,1.50,0.00,GBP,COMPLETED,103127.97
TRANSFER,Deposit,2022-05-31 18:14:02,2022-05-31 18:14:02,To GBP Rainy day,0.24,0.00,GBP,COMPLETED,103128.21
TRANSFER,Deposit,2022-05-31 19:24:23,2022-05-31 19:24:23,To GBP Rainy day,1.98,0.00,GBP,COMPLETED,103130.19
TRANSFER,Deposit,2022-05-31 19:40:23,2022-05-31 19:40:23,To GBP Rainy day,1.98,0.00,GBP,COMPLETED,103132.17
TRANSFER,Deposit,2022-05-31 20:05:41,2022-05-31 20:05:41,To GBP Rainy day,0.51,0.00,GBP,COMPLETED,103132.68
TRANSFER,Deposit,2022-05-31 22:08:19,2022-05-31 22:08:19,To GBP Rainy day,2.10,0.00,GBP,COMPLETED,103134.78
TRANSFER,Deposit,2022-05-31 22:45:17,2022-05-31 22:45:17,To GBP Rainy day,0.96,0.00,GBP,COMPLETED,103135.74
TRANSFER,Deposit,2022-06-01 07:10:21,2022-06-01 07:10:21,To GBP Rainy day,5.00,0.00,GBP,COMPLETED,103140.74
TRANSFER,Deposit,2022-06-01 11:22:33,2022-06-01 11:22:33,To GBP Rainy day,1.95,0.00,GBP,COMPLETED,103142.69
TRANSFER,Deposit,2022-06-01 12:36:53,2022-06-01 12:36:54,To GBP Rainy day,1.65,0.00,GBP,COMPLETED,103144.34
TRANSFER,Deposit,2022-06-01 14:12:17,2022-06-01 14:12:17,To GBP Rainy day,0.03,0.00,GBP,COMPLETED,103144.37
TRANSFER,Deposit,2022-06-01 14:23:24,2022-06-01 14:23:24,To GBP Rainy day,0.03,0.00,GBP,COMPLETED,103144.40
TRANSFER,Deposit,2022-06-01 15:47:16,2022-06-01 15:47:16,To GBP Rainy day,1.95,0.00,GBP,COMPLETED,103146.35
TRANSFER,Deposit,2022-06-01 19:47:49,2022-06-01 19:47:49,To GBP Rainy day,3.00,0.00,GBP,COMPLETED,103149.35
TRANSFER,Deposit,2022-06-01 19:52:41,2022-06-01 19:52:41,To GBP Rainy day,0.60,0.00,GBP,COMPLETED,103149.95
TRANSFER,Deposit,2022-06-02 07:06:49,2022-06-02 07:06:49,To GBP Rainy day,5.00,0.00,GBP,COMPLETED,103154.95
TRANSFER,Deposit,2022-06-02 10:15:55,2022-06-02 10:15:55,To GBP Rainy day,1.95,0.00,GBP,COMPLETED,103156.90
TRANSFER,Deposit,2022-06-02 13:55:32,2022-06-02 13:55:32,To GBP Rainy day,2.43,0.00,GBP,COMPLETED,103159.33
TRANSFER,Deposit,2022-06-02 15:31:00,2022-06-02 15:31:00,To GBP Rainy day,3.00,0.00,GBP,COMPLETED,103162.33
TRANSFER,Deposit,2022-06-02 17:55:57,2022-06-02 17:55:57,To GBP Rainy day,0.03,0.00,GBP,COMPLETED,103162.36
TRANSFER,Deposit,2022-06-03 01:29:13,2022-06-03 01:29:13,To GBP Rainy day,2.40,0.00,GBP,COMPLETED,103164.76
TRANSFER,Deposit,2022-06-03 07:08:52,2022-06-03 07:08:52,To GBP Rainy day,5.00,0.00,GBP,COMPLETED,103169.76
TRANSFER,Deposit,2022-06-03 12:30:45,2022-06-03 12:30:45,To GBP Rainy day,2.55,0.00,GBP,COMPLETED,103172.31
TRANSFER,Deposit,2022-06-03 18:05:05,2022-06-03 18:05:05,To GBP,-16650.00,0.00,GBP,COMPLETED,86522.31
TRANSFER,Deposit,2022-06-03 20:02:47,2022-06-03 20:02:47,To GBP Rainy day,1.20,0.00,GBP,COMPLETED,86523.51
TRANSFER,Deposit,2022-06-03 20:20:51,2022-06-03 20:20:51,To GBP Rainy day,2.40,0.00,GBP,COMPLETED,86525.91
TRANSFER,Deposit,2022-06-04 07:05:43,2022-06-04 07:05:43,To GBP Rainy day,5.00,0.00,GBP,COMPLETED,86530.91
TRANSFER,Deposit,2022-06-04 10:16:04,2022-06-04 10:16:04,To GBP Rainy day,1.95,0.00,GBP,COMPLETED,86532.86
TRANSFER,Deposit,2022-06-04 10:56:28,2022-06-04 10:56:28,To GBP Rainy day,1.05,0.00,GBP,COMPLETED,86533.91
TRANSFER,Deposit,2022-06-04 11:01:55,2022-06-04 11:01:55,To GBP Rainy day,0.06,0.00,GBP,COMPLETED,86533.97
TRANSFER,Deposit,2022-06-04 11:57:11,2022-06-04 11:57:11,To GBP Rainy day,0.60,0.00,GBP,COMPLETED,86534.57
TRANSFER,Deposit,2022-06-05 07:06:04,2022-06-05 07:06:04,To GBP Rainy day,5.00,0.00,GBP,COMPLETED,86539.57
TRANSFER,Deposit,2022-06-05 11:43:38,2022-06-05 11:43:38,To GBP Rainy day,1.95,0.00,GBP,COMPLETED,86541.52
TRANSFER,Deposit,2022-06-05 12:13:15,2022-06-05 12:13:15,To GBP Rainy day,3.00,0.00,GBP,COMPLETED,86544.52
TRANSFER,Deposit,2022-06-05 13:30:55,2022-06-05 13:30:55,To GBP Rainy day,0.06,0.00,GBP,COMPLETED,86544.58
TRANSFER,Deposit,2022-06-05 15:21:26,2022-06-05 15:21:26,To GBP Rainy day,1.95,0.00,GBP,COMPLETED,86546.53
TRANSFER,Deposit,2022-06-05 18:28:05,2022-06-05 18:28:05,To GBP Rainy day,0.60,0.00,GBP,COMPLETED,86547.13
TRANSFER,Deposit,2022-06-05 19:51:40,2022-06-05 19:51:40,To GBP Rainy day,2.76,0.00,GBP,COMPLETED,86549.89
TRANSFER,Deposit,2022-06-06 01:15:34,2022-06-06 01:15:34,To GBP Rainy day,0.60,0.00,GBP,COMPLETED,86550.49
TRANSFER,Deposit,2022-06-06 07:23:10,2022-06-06 07:23:10,To GBP Rainy day,5.00,0.00,GBP,COMPLETED,86555.49
TRANSFER,Deposit,2022-06-06 09:52:52,2022-06-06 09:52:52,To GBP Rainy day,1.95,0.00,GBP,COMPLETED,86557.44
TRANSFER,Deposit,2022-06-06 11:39:42,2022-06-06 11:39:42,To GBP Rainy day,0.03,0.00,GBP,COMPLETED,86557.47
TRANSFER,Deposit,2022-06-06 14:04:15,2022-06-06 14:04:15,To GBP Rainy day,0.75,0.00,GBP,COMPLETED,86558.22
TRANSFER,Deposit,2022-06-07 06:49:22,2022-06-07 06:49:22,To GBP Rainy day,1.38,0.00,GBP,COMPLETED,86559.60
TRANSFER,Deposit,2022-06-07 07:05:06,2022-06-07 07:05:06,To GBP Rainy day,5.00,0.00,GBP,COMPLETED,86564.60
TRANSFER,Deposit,2022-06-07 07:23:28,2022-06-07 07:23:28,To GBP Rainy day,0.03,0.00,GBP,COMPLETED,86564.63
TRANSFER,Deposit,2022-06-07 07:26:37,2022-06-07 07:26:37,To GBP Rainy day,0.03,0.00,GBP,COMPLETED,86564.66
TRANSFER,Deposit,2022-06-07 07:28:59,2022-06-07 07:28:59,To GBP Rainy day,2.25,0.00,GBP,COMPLETED,86566.91
EXCHANGE,Deposit,2022-06-07 10:16:04,2022-06-07 10:16:04,Exchanged to GBP Rainy day,0.64,0.00,GBP,COMPLETED,86567.55
EXCHANGE,Deposit,2022-06-07 10:27:08,2022-06-07 10:27:08,Exchanged to GBP Rainy day,0.76,0.00,GBP,COMPLETED,86568.31
TRANSFER,Deposit,2022-06-07 11:34:31,2022-06-07 11:34:31,To GBP Rainy day,2.61,0.00,GBP,COMPLETED,86570.92
TRANSFER,Deposit,2022-06-07 14:23:57,2022-06-07 14:23:57,To GBP Rainy day,1.38,0.00,GBP,COMPLETED,86572.30
TRANSFER,Deposit,2022-06-07 14:32:00,2022-06-07 14:32:00,To GBP Rainy day,1.53,0.00,GBP,COMPLETED,86573.83
TRANSFER,Deposit,2022-06-07 14:55:40,2022-06-07 14:55:40,To GBP Rainy day,0.12,0.00,GBP,COMPLETED,86573.95
TRANSFER,Deposit,2022-06-07 21:53:11,2022-06-07 21:53:11,To GBP Rainy day,0.12,0.00,GBP,COMPLETED,86574.07
TRANSFER,Deposit,2022-06-08 07:05:20,2022-06-08 07:05:20,To GBP Rainy day,5.00,0.00,GBP,COMPLETED,86579.07
TRANSFER,Deposit,2022-06-08 09:38:03,2022-06-08 09:38:03,To GBP Rainy day,0.84,0.00,GBP,COMPLETED,86579.91
TRANSFER,Deposit,2022-06-08 12:44:05,2022-06-08 12:44:05,To GBP Rainy day,2.16,0.00,GBP,COMPLETED,86582.07
TRANSFER,Deposit,2022-06-08 17:56:04,2022-06-08 17:56:04,To GBP Rainy day,1.32,0.00,GBP,COMPLETED,86583.39
TRANSFER,Deposit,2022-06-08 18:02:42,2022-06-08 18:02:42,To GBP Rainy day,0.84,0.00,GBP,COMPLETED,86584.23
TRANSFER,Deposit,2022-06-08 18:50:41,2022-06-08 18:50:41,To GBP Rainy day,1.35,0.00,GBP,COMPLETED,86585.58
TRANSFER,Deposit,2022-06-08 19:45:14,2022-06-08 19:45:14,To GBP Rainy day,2.76,0.00,GBP,COMPLETED,86588.34
TRANSFER,Deposit,2022-06-08 20:42:37,2022-06-08 20:42:37,To GBP Rainy day,2.28,0.00,GBP,COMPLETED,86590.62
TRANSFER,Deposit,2022-06-08 20:57:51,2022-06-08 20:57:51,To GBP Rainy day,1.32,0.00,GBP,COMPLETED,86591.94
TRANSFER,Deposit,2022-06-08 22:37:04,2022-06-08 22:37:04,To GBP Rainy day,3.00,0.00,GBP,COMPLETED,86594.94
TRANSFER,Deposit,2022-06-09 06:55:15,2022-06-09 06:55:15,To GBP Rainy day,3.00,0.00,GBP,COMPLETED,86597.94
TRANSFER,Deposit,2022-06-09 07:06:12,2022-06-09 07:06:12,To GBP Rainy day,5.00,0.00,GBP,COMPLETED,86602.94
TRANSFER,Deposit,2022-06-09 07:06:56,2022-06-09 07:06:56,To GBP Rainy day,0.81,0.00,GBP,COMPLETED,86603.75
TRANSFER,Deposit,2022-06-09 07:38:20,2022-06-09 07:38:20,To GBP Rainy day,0.33,0.00,GBP,COMPLETED,86604.08
TRANSFER,Deposit,2022-06-09 08:06:26,2022-06-09 08:06:26,To GBP Rainy day,1.89,0.00,GBP,COMPLETED,86605.97
TRANSFER,Deposit,2022-06-09 09:14:39,2022-06-09 09:14:39,To GBP Rainy day,0.36,0.00,GBP,COMPLETED,86606.33
TRANSFER,Deposit,2022-06-09 09:20:26,2022-06-09 09:20:26,To GBP Rainy day,1.35,0.00,GBP,COMPLETED,86607.68
TRANSFER,Deposit,2022-06-09 09:31:14,2022-06-09 09:31:14,To GBP Rainy day,0.87,0.00,GBP,COMPLETED,86608.55
TRANSFER,Deposit,2022-06-09 10:12:59,2022-06-09 10:12:59,To GBP Rainy day,2.22,0.00,GBP,COMPLETED,86610.77
TRANSFER,Deposit,2022-06-09 12:46:37,2022-06-09 12:46:37,To GBP Rainy day,3.00,0.00,GBP,COMPLETED,86613.77
TRANSFER,Deposit,2022-06-10 01:37:41,2022-06-10 01:37:41,To GBP Rainy day,0.90,0.00,GBP,COMPLETED,86614.67
TRANSFER,Deposit,2022-06-10 07:09:08,2022-06-10 07:09:08,To GBP Rainy day,5.00,0.00,GBP,COMPLETED,86619.67
TRANSFER,Deposit,2022-06-10 09:50:15,2022-06-10 09:50:15,To GBP Rainy day,0.12,0.00,GBP,COMPLETED,86619.79
TRANSFER,Deposit,2022-06-10 09:53:43,2022-06-10 09:53:43,To GBP Rainy day,1.95,0.00,GBP,COMPLETED,86621.74
TRANSFER,Deposit,2022-06-10 11:02:18,2022-06-10 11:02:18,To GBP Rainy day,1.95,0.00,GBP,COMPLETED,86623.69
TRANSFER,Deposit,2022-06-10 14:06:34,2022-06-10 14:06:34,To GBP Rainy day,0.15,0.00,GBP,COMPLETED,86623.84
TRANSFER,Deposit,2022-06-10 17:00:29,2022-06-10 17:00:29,To GBP Rainy day,1.80,0.00,GBP,COMPLETED,86625.64
TRANSFER,Deposit,2022-06-10 17:30:10,2022-06-10 17:30:10,To GBP Rainy day,0.30,0.00,GBP,COMPLETED,86625.94
TRANSFER,Deposit,2022-06-11 07:05:36,2022-06-11 07:05:36,To GBP Rainy day,5.00,0.00,GBP,COMPLETED,86630.94
TRANSFER,Deposit,2022-06-11 12:08:24,2022-06-11 12:08:24,To GBP Rainy day,0.03,0.00,GBP,COMPLETED,86630.97
TRANSFER,Deposit,2022-06-11 14:24:59,2022-06-11 14:24:59,To GBP Rainy day,2.55,0.00,GBP,COMPLETED,86633.52
TRANSFER,Deposit,2022-06-11 18:25:33,2022-06-11 18:25:33,To GBP Rainy day,0.09,0.00,GBP,COMPLETED,86633.61
TRANSFER,Deposit,2022-06-11 18:47:46,2022-06-11 18:47:46,To GBP Rainy day,1.20,0.00,GBP,COMPLETED,86634.81
TRANSFER,Deposit,2022-06-11 20:53:56,2022-06-11 20:53:56,To GBP Rainy day,2.40,0.00,GBP,COMPLETED,86637.21
TRANSFER,Deposit,2022-06-11 21:23:02,2022-06-11 21:23:02,To GBP Rainy day,3.00,0.00,GBP,COMPLETED,86640.21
TRANSFER,Deposit,2022-06-11 22:31:51,2022-06-11 22:31:51,To GBP Rainy day,0.54,0.00,GBP,COMPLETED,86640.75
TRANSFER,Deposit,2022-06-12 01:26:59,2022-06-12 01:26:59,To GBP Rainy day,1.20,0.00,GBP,COMPLETED,86641.95
TRANSFER,Deposit,2022-06-12 07:05:21,2022-06-12 07:05:21,To GBP Rainy day,5.00,0.00,GBP,COMPLETED,86646.95
TRANSFER,Deposit,2022-06-12 11:42:57,2022-06-12 11:42:57,To GBP Rainy day,1.74,0.00,GBP,COMPLETED,86648.69
TRANSFER,Deposit,2022-06-12 12:20:50,2022-06-12 12:20:50,To GBP Rainy day,2.10,0.00,GBP,COMPLETED,86650.79
TRANSFER,Deposit,2022-06-12 12:30:01,2022-06-12 12:30:01,To GBP Rainy day,2.40,0.00,GBP,COMPLETED,86653.19
TRANSFER,Deposit,2022-06-12 12:49:51,2022-06-12 12:49:51,To GBP Rainy day,2.70,0.00,GBP,COMPLETED,86655.89
TRANSFER,Deposit,2022-06-12 14:17:43,2022-06-12 14:17:43,To GBP Rainy day,1.95,0.00,GBP,COMPLETED,86657.84
TRANSFER,Deposit,2022-06-12 14:46:38,2022-06-12 14:46:38,To GBP Rainy day,0.30,0.00,GBP,COMPLETED,86658.14
TRANSFER,Deposit,2022-06-12 17:04:06,2022-06-12 17:04:06,To GBP Rainy day,3.00,0.00,GBP,COMPLETED,86661.14
TRANSFER,Deposit,2022-06-12 17:31:39,2022-06-12 17:31:39,To GBP Rainy day,1.20,0.00,GBP,COMPLETED,86662.34
TRANSFER,Deposit,2022-06-12 18:03:35,2022-06-12 18:03:35,To GBP Rainy day,1.20,0.00,GBP,COMPLETED,86663.54
TRANSFER,Deposit,2022-06-12 19:30:12,2022-06-12 19:30:12,To GBP Rainy day,2.70,0.00,GBP,COMPLETED,86666.24
TRANSFER,Deposit,2022-06-12 19:34:22,2022-06-12 19:34:22,To GBP Rainy day,0.90,0.00,GBP,COMPLETED,86667.14
TRANSFER,Deposit,2022-06-12 20:35:32,2022-06-12 20:35:32,To GBP Rainy day,1.50,0.00,GBP,COMPLETED,86668.64
TRANSFER,Deposit,2022-06-12 20:38:45,2022-06-12 20:38:45,To GBP Rainy day,1.50,0.00,GBP,COMPLETED,86670.14
TRANSFER,Deposit,2022-06-13 07:23:14,2022-06-13 07:23:14,To GBP Rainy day,5.00,0.00,GBP,COMPLETED,86675.14
TRANSFER,Deposit,2022-06-13 10:26:07,2022-06-13 10:26:07,To GBP Rainy day,1.20,0.00,GBP,COMPLETED,86676.34
TRANSFER,Deposit,2022-06-13 12:47:04,2022-06-13 12:47:04,To GBP Rainy day,0.15,0.00,GBP,COMPLETED,86676.49
TRANSFER,Deposit,2022-06-13 14:23:51,2022-06-13 14:23:51,To GBP Rainy day,0.90,0.00,GBP,COMPLETED,86677.39
TRANSFER,Deposit,2022-06-13 18:31:34,2022-06-13 18:31:34,To GBP Rainy day,0.45,0.00,GBP,COMPLETED,86677.84
TRANSFER,Deposit,2022-06-14 01:30:07,2022-06-14 01:30:07,To GBP Rainy day,1.20,0.00,GBP,COMPLETED,86679.04
TRANSFER,Deposit,2022-06-14 07:04:55,2022-06-14 07:04:55,To GBP Rainy day,5.00,0.00,GBP,COMPLETED,86684.04
TRANSFER,Deposit,2022-06-14 11:30:01,2022-06-14 11:30:01,To GBP Rainy day,1.95,0.00,GBP,COMPLETED,86685.99
TRANSFER,Deposit,2022-06-14 13:14:53,2022-06-14 13:14:53,To GBP Rainy day,0.09,0.00,GBP,COMPLETED,86686.08
TRANSFER,Deposit,2022-06-14 13:20:55,2022-06-14 13:20:55,To GBP Rainy day,2.40,0.00,GBP,COMPLETED,86688.48
TRANSFER,Deposit,2022-06-14 20:12:26,2022-06-14 20:12:26,To GBP Rainy day,2.07,0.00,GBP,COMPLETED,86690.55
TRANSFER,Deposit,2022-06-14 20:34:03,2022-06-14 20:34:03,To GBP Rainy day,1.20,0.00,GBP,COMPLETED,86691.75
TRANSFER,Deposit,2022-06-14 20:59:54,2022-06-14 20:59:54,To GBP Rainy day,0.15,0.00,GBP,COMPLETED,86691.90
TRANSFER,Deposit,2022-06-15 07:05:58,2022-06-15 07:05:58,To GBP Rainy day,5.00,0.00,GBP,COMPLETED,86696.90
TRANSFER,Deposit,2022-06-15 10:44:09,2022-06-15 10:44:09,To GBP Rainy day,1.95,0.00,GBP,COMPLETED,86698.85
TRANSFER,Deposit,2022-06-15 11:53:25,2022-06-15 11:53:25,To GBP Rainy day,0.06,0.00,GBP,COMPLETED,86698.91
TRANSFER,Deposit,2022-06-15 12:01:02,2022-06-15 12:01:02,To GBP Rainy day,2.40,0.00,GBP,COMPLETED,86701.31
TRANSFER,Deposit,2022-06-15 13:54:10,2022-06-15 13:54:10,To GBP Rainy day,0.90,0.00,GBP,COMPLETED,86702.21
TRANSFER,Deposit,2022-06-15 19:27:57,2022-06-15 19:27:57,To GBP Rainy day,1.14,0.00,GBP,COMPLETED,86703.35
TRANSFER,Deposit,2022-06-16 01:48:42,2022-06-16 01:48:42,To GBP Rainy day,1.20,0.00,GBP,COMPLETED,86704.55
TRANSFER,Deposit,2022-06-16 07:06:22,2022-06-16 07:06:22,To GBP Rainy day,5.00,0.00,GBP,COMPLETED,86709.55
TRANSFER,Deposit,2022-06-16 10:08:24,2022-06-16 10:08:24,To GBP Rainy day,1.95,0.00,GBP,COMPLETED,86711.50
TRANSFER,Deposit,2022-06-16 11:47:01,2022-06-16 11:47:01,To GBP Rainy day,3.00,0.00,GBP,COMPLETED,86714.50
TRANSFER,Deposit,2022-06-16 13:29:34,2022-06-16 13:29:34,To GBP Rainy day,0.06,0.00,GBP,COMPLETED,86714.56
TRANSFER,Deposit,2022-06-16 13:31:21,2022-06-16 13:31:21,To GBP Rainy day,1.65,0.00,GBP,COMPLETED,86716.21
TRANSFER,Deposit,2022-06-16 19:32:19,2022-06-16 19:32:19,To GBP Rainy day,1.20,0.00,GBP,COMPLETED,86717.41
TRANSFER,Deposit,2022-06-16 19:49:52,2022-06-16 19:49:52,To GBP Rainy day,3.00,0.00,GBP,COMPLETED,86720.41
TRANSFER,Deposit,2022-06-17 07:08:20,2022-06-17 07:08:20,To GBP Rainy day,5.00,0.00,GBP,COMPLETED,86725.41
TRANSFER,Deposit,2022-06-17 08:21:11,2022-06-17 08:21:11,To GBP Rainy day,1.95,0.00,GBP,COMPLETED,86727.36
TRANSFER,Deposit,2022-06-17 11:00:38,2022-06-17 11:00:38,To GBP Rainy day,3.00,0.00,GBP,COMPLETED,86730.36
TRANSFER,Deposit,2022-06-17 13:08:36,2022-06-17 13:08:36,To GBP Rainy day,0.09,0.00,GBP,COMPLETED,86730.45
TRANSFER,Deposit,2022-06-17 16:51:20,2022-06-17 16:51:20,To GBP Rainy day,2.13,0.00,GBP,COMPLETED,86732.58
TRANSFER,Deposit,2022-06-17 19:44:03,2022-06-17 19:44:03,To GBP Rainy day,1.41,0.00,GBP,COMPLETED,86733.99
TRANSFER,Deposit,2022-06-18 01:33:23,2022-06-18 01:33:23,To GBP Rainy day,1.80,0.00,GBP,COMPLETED,86735.79
TRANSFER,Deposit,2022-06-18 07:05:30,2022-06-18 07:05:30,To GBP Rainy day,5.00,0.00,GBP,COMPLETED,86740.79
TRANSFER,Deposit,2022-06-18 07:49:47,2022-06-18 07:49:47,To GBP Rainy day,0.63,0.00,GBP,COMPLETED,86741.42
TRANSFER,Deposit,2022-06-18 10:27:07,2022-06-18 10:27:07,To GBP Rainy day,0.60,0.00,GBP,COMPLETED,86742.02
TRANSFER,Deposit,2022-06-18 11:05:06,2022-06-18 11:05:06,To GBP Rainy day,3.00,0.00,GBP,COMPLETED,86745.02
TRANSFER,Deposit,2022-06-18 17:52:20,2022-06-18 17:52:20,To GBP Rainy day,3.00,0.00,GBP,COMPLETED,86748.02
TRANSFER,Deposit,2022-06-18 18:33:36,2022-06-18 18:33:36,To GBP Rainy day,0.75,0.00,GBP,COMPLETED,86748.77
TRANSFER,Deposit,2022-06-18 18:39:52,2022-06-18 18:39:52,To GBP Rainy day,1.77,0.00,GBP,COMPLETED,86750.54
TRANSFER,Deposit,2022-06-18 19:24:53,2022-06-18 19:24:53,To GBP Rainy day,1.74,0.00,GBP,COMPLETED,86752.28
TRANSFER,Deposit,2022-06-18 22:42:19,2022-06-18 22:42:19,To GBP Rainy day,2.31,0.00,GBP,COMPLETED,86754.59
TRANSFER,Deposit,2022-06-18 22:49:46,2022-06-18 22:49:46,To GBP Rainy day,3.00,0.00,GBP,COMPLETED,86757.59
TRANSFER,Deposit,2022-06-19 01:41:22,2022-06-19 01:41:22,To GBP Rainy day,1.20,0.00,GBP,COMPLETED,86758.79
TRANSFER,Deposit,2022-06-19 07:05:13,2022-06-19 07:05:13,To GBP Rainy day,5.00,0.00,GBP,COMPLETED,86763.79
TRANSFER,Deposit,2022-06-19 10:32:59,2022-06-19 10:32:59,To GBP Rainy day,0.69,0.00,GBP,COMPLETED,86764.48
TRANSFER,Deposit,2022-06-19 11:05:22,2022-06-19 11:05:22,To GBP Rainy day,0.90,0.00,GBP,COMPLETED,86765.38
TRANSFER,Deposit,2022-06-19 11:13:35,2022-06-19 11:13:35,To GBP Rainy day,3.00,0.00,GBP,COMPLETED,86768.38
TRANSFER,Deposit,2022-06-19 13:49:54,2022-06-19 13:49:54,To GBP Rainy day,0.03,0.00,GBP,COMPLETED,86768.41
TRANSFER,Deposit,2022-06-20 01:16:50,2022-06-20 01:16:50,To GBP Rainy day,1.20,0.00,GBP,COMPLETED,86769.61
TRANSFER,Deposit,2022-06-20 07:23:41,2022-06-20 07:23:41,To GBP Rainy day,5.00,0.00,GBP,COMPLETED,86774.61
TRANSFER,Deposit,2022-06-20 07:58:59,2022-06-20 07:58:59,To GBP Rainy day,1.95,0.00,GBP,COMPLETED,86776.56
TRANSFER,Deposit,2022-06-20 09:35:16,2022-06-20 09:35:16,To GBP Rainy day,1.95,0.00,GBP,COMPLETED,86778.51
TRANSFER,Deposit,2022-06-20 11:45:05,2022-06-20 11:45:05,To GBP Rainy day,0.75,0.00,GBP,COMPLETED,86779.26
TRANSFER,Deposit,2022-06-20 14:56:22,2022-06-20 14:56:22,To GBP Rainy day,3.00,0.00,GBP,COMPLETED,86782.26
TRANSFER,Deposit,2022-06-20 15:36:20,2022-06-20 15:36:20,To GBP Rainy day,2.91,0.00,GBP,COMPLETED,86785.17
TRANSFER,Deposit,2022-06-20 16:47:28,2022-06-20 16:47:28,To GBP Rainy day,3.00,0.00,GBP,COMPLETED,86788.17
TRANSFER,Deposit,2022-06-20 17:02:43,2022-06-20 17:02:43,To GBP Rainy day,0.66,0.00,GBP,COMPLETED,86788.83
TRANSFER,Deposit,2022-06-21 07:04:53,2022-06-21 07:04:53,To GBP Rainy day,5.00,0.00,GBP,COMPLETED,86793.83
TRANSFER,Deposit,2022-06-21 09:06:45,2022-06-21 09:06:45,To GBP Rainy day,1.95,0.00,GBP,COMPLETED,86795.78
TRANSFER,Deposit,2022-06-21 14:53:28,2022-06-21 14:53:28,To GBP Rainy day,2.40,0.00,GBP,COMPLETED,86798.18
TRANSFER,Deposit,2022-06-21 17:30:26,2022-06-21 17:30:26,To GBP Rainy day,0.45,0.00,GBP,COMPLETED,86798.63
TRANSFER,Deposit,2022-06-21 20:37:28,2022-06-21 20:37:28,To GBP Rainy day,0.90,0.00,GBP,COMPLETED,86799.53
TRANSFER,Deposit,2022-06-21 21:00:32,2022-06-21 21:00:32,To GBP Rainy day,0.60,0.00,GBP,COMPLETED,86800.13
TRANSFER,Deposit,2022-06-21 21:48:45,2022-06-21 21:48:45,To GBP Rainy day,3.00,0.00,GBP,COMPLETED,86803.13
TRANSFER,Deposit,2022-06-21 21:52:51,2022-06-21 21:52:51,To GBP Rainy day,3.00,0.00,GBP,COMPLETED,86806.13
TRANSFER,Deposit,2022-06-21 22:03:03,2022-06-21 22:03:03,To GBP Rainy day,1.83,0.00,GBP,COMPLETED,86807.96
TRANSFER,Deposit,2022-06-21 22:55:51,2022-06-21 22:55:51,To GBP Rainy day,3.00,0.00,GBP,COMPLETED,86810.96
TRANSFER,Deposit,2022-06-22 03:17:19,2022-06-22 03:17:19,To GBP Rainy day,0.03,0.00,GBP,COMPLETED,86810.99
TRANSFER,Deposit,2022-06-22 07:05:08,2022-06-22 07:05:08,To GBP Rainy day,5.00,0.00,GBP,COMPLETED,86815.99
TRANSFER,Deposit,2022-06-22 09:30:46,2022-06-22 09:30:46,To GBP Rainy day,2.10,0.00,GBP,COMPLETED,86818.09
TRANSFER,Deposit,2022-06-22 09:51:35,2022-06-22 09:51:35,To GBP Rainy day,0.90,0.00,GBP,COMPLETED,86818.99
TRANSFER,Deposit,2022-06-22 13:34:59,2022-06-22 13:34:59,To GBP Rainy day,1.95,0.00,GBP,COMPLETED,86820.94
TRANSFER,Deposit,2022-06-22 19:00:41,2022-06-22 19:00:41,To GBP Rainy day,1.80,0.00,GBP,COMPLETED,86822.74
TRANSFER,Deposit,2022-06-23 07:06:10,2022-06-23 07:06:10,To GBP Rainy day,5.00,0.00,GBP,COMPLETED,86827.74
TRANSFER,Deposit,2022-06-23 10:13:21,2022-06-23 10:13:21,To GBP Rainy day,1.95,0.00,GBP,COMPLETED,86829.69
TRANSFER,Deposit,2022-06-23 11:47:24,2022-06-23 11:47:24,To GBP Rainy day,2.40,0.00,GBP,COMPLETED,86832.09
TRANSFER,Deposit,2022-06-23 15:12:03,2022-06-23 15:12:03,To GBP,-27000.00,0.00,GBP,COMPLETED,59832.09
TRANSFER,Deposit,2022-06-23 18:04:11,2022-06-23 18:04:11,To GBP Rainy day,1.50,0.00,GBP,COMPLETED,59833.59
TRANSFER,Deposit,2022-06-23 18:35:53,2022-06-23 18:35:53,To GBP Rainy day,2.85,0.00,GBP,COMPLETED,59836.44
TRANSFER,Deposit,2022-06-23 18:39:46,2022-06-23 18:39:46,To GBP Rainy day,1.50,0.00,GBP,COMPLETED,59837.94
TRANSFER,Deposit,2022-06-23 19:08:48,2022-06-23 19:08:48,To GBP Rainy day,1.50,0.00,GBP,COMPLETED,59839.44
TRANSFER,Deposit,2022-06-23 19:39:48,2022-06-23 19:39:48,To GBP Rainy day,1.50,0.00,GBP,COMPLETED,59840.94
TRANSFER,Deposit,2022-06-23 19:54:17,2022-06-23 19:54:17,To GBP Rainy day,3.00,0.00,GBP,COMPLETED,59843.94
TRANSFER,Deposit,2022-06-23 20:12:52,2022-06-23 20:12:52,To GBP Rainy day,1.50,0.00,GBP,COMPLETED,59845.44
TRANSFER,Deposit,2022-06-23 21:08:14,2022-06-23 21:08:14,To GBP Rainy day,0.93,0.00,GBP,COMPLETED,59846.37
TRANSFER,Deposit,2022-06-23 21:08:53,2022-06-23 21:08:53,To GBP Rainy day,3.00,0.00,GBP,COMPLETED,59849.37
TRANSFER,Deposit,2022-06-24 01:24:38,2022-06-24 01:24:38,To GBP Rainy day,1.20,0.00,GBP,COMPLETED,59850.57
TRANSFER,Deposit,2022-06-24 07:08:16,2022-06-24 07:08:16,To GBP Rainy day,5.00,0.00,GBP,COMPLETED,59855.57
TRANSFER,Deposit,2022-06-24 11:11:49,2022-06-24 11:11:49,To GBP Rainy day,1.95,0.00,GBP,COMPLETED,59857.52
TRANSFER,Deposit,2022-06-24 14:43:30,2022-06-24 14:43:30,To GBP Rainy day,2.10,0.00,GBP,COMPLETED,59859.62
TRANSFER,Deposit,2022-06-24 18:42:17,2022-06-24 18:42:17,To GBP Rainy day,1.20,0.00,GBP,COMPLETED,59860.82
TRANSFER,Deposit,2022-06-25 07:05:52,2022-06-25 07:05:52,To GBP Rainy day,5.00,0.00,GBP,COMPLETED,59865.82
TRANSFER,Deposit,2022-06-25 10:03:49,2022-06-25 10:03:49,To GBP Rainy day,0.12,0.00,GBP,COMPLETED,59865.94
TRANSFER,Deposit,2022-06-25 20:33:01,2022-06-25 20:33:01,To GBP Rainy day,1.11,0.00,GBP,COMPLETED,59867.05
TRANSFER,Deposit,2022-06-25 20:56:32,2022-06-25 20:56:32,To GBP Rainy day,0.03,0.00,GBP,COMPLETED,59867.08
TRANSFER,Deposit,2022-06-26 00:02:01,2022-06-26 00:02:01,To GBP Rainy day,3.00,0.00,GBP,COMPLETED,59870.08
TRANSFER,Deposit,2022-06-26 07:05:36,2022-06-26 07:05:36,To GBP Rainy day,5.00,0.00,GBP,COMPLETED,59875.08
TRANSFER,Deposit,2022-06-26 13:06:11,2022-06-26 13:06:11,To GBP Rainy day,1.95,0.00,GBP,COMPLETED,59877.03
TRANSFER,Deposit,2022-06-26 14:40:03,2022-06-26 14:40:03,To GBP Rainy day,0.03,0.00,GBP,COMPLETED,59877.06
TRANSFER,Deposit,2022-06-27 07:24:06,2022-06-27 07:24:06,To GBP Rainy day,5.00,0.00,GBP,COMPLETED,59882.06
TRANSFER,Deposit,2022-06-27 10:33:25,2022-06-27 10:33:25,To GBP Rainy day,2.10,0.00,GBP,COMPLETED,59884.16
TRANSFER,Deposit,2022-06-27 11:12:02,2022-06-27 11:12:02,To GBP,-4000.00,0.00,GBP,COMPLETED,55884.16
TRANSFER,Deposit,2022-06-27 11:12:34,2022-06-27 11:12:34,To GBP,-534.16,0.00,GBP,COMPLETED,55350.00
TRANSFER,Deposit,2022-06-27 13:49:20,2022-06-27 13:49:20,To GBP Rainy day,0.99,0.00,GBP,COMPLETED,55350.99
TRANSFER,Deposit,2022-06-27 13:54:26,2022-06-27 13:54:26,To GBP Rainy day,1.65,0.00,GBP,COMPLETED,55352.64
TRANSFER,Deposit,2022-06-27 19:18:42,2022-06-27 19:18:42,To GBP Rainy day,0.03,0.00,GBP,COMPLETED,55352.67
TRANSFER,Deposit,2022-06-28 07:05:27,2022-06-28 07:05:27,To GBP Rainy day,5.00,0.00,GBP,COMPLETED,55357.67
TRANSFER,Deposit,2022-06-28 10:13:45,2022-06-28 10:13:45,To GBP Rainy day,1.95,0.00,GBP,COMPLETED,55359.62
TRANSFER,Deposit,2022-06-28 10:58:03,2022-06-28 10:58:03,To GBP Rainy day,3.00,0.00,GBP,COMPLETED,55362.62
TRANSFER,Deposit,2022-06-28 13:03:27,2022-06-28 13:03:27,To GBP Rainy day,0.45,0.00,GBP,COMPLETED,55363.07
TRANSFER,Deposit,2022-06-28 13:42:20,2022-06-28 13:42:20,To GBP,-22000.00,0.00,GBP,COMPLETED,33363.07
TRANSFER,Deposit,2022-06-29 01:33:04,2022-06-29 01:33:04,To GBP Rainy day,0.60,0.00,GBP,COMPLETED,33363.67
TRANSFER,Deposit,2022-06-29 05:28:09,2022-06-29 05:28:09,To GBP Rainy day,0.90,0.00,GBP,COMPLETED,33364.57
TRANSFER,Deposit,2022-06-29 07:05:22,2022-06-29 07:05:22,To GBP Rainy day,5.00,0.00,GBP,COMPLETED,33369.57
TRANSFER,Deposit,2022-06-29 09:16:05,2022-06-29 09:16:05,To GBP Rainy day,0.12,0.00,GBP,COMPLETED,33369.69
TRANSFER,Deposit,2022-06-29 10:05:14,2022-06-29 10:05:14,To GBP Rainy day,1.95,0.00,GBP,COMPLETED,33371.64
TRANSFER,Deposit,2022-06-29 12:37:36,2022-06-29 12:37:36,To GBP Rainy day,3.00,0.00,GBP,COMPLETED,33374.64
TRANSFER,Deposit,2022-06-29 13:39:02,2022-06-29 13:39:02,To GBP Rainy day,0.03,0.00,GBP,COMPLETED,33374.67
TRANSFER,Deposit,2022-06-29 16:48:13,2022-06-29 16:48:13,To GBP Rainy day,2.43,0.00,GBP,COMPLETED,33377.10
TRANSFER,Deposit,2022-06-29 19:00:00,2022-06-29 19:00:00,To GBP Rainy day,0.99,0.00,GBP,COMPLETED,33378.09
TRANSFER,Deposit,2022-06-29 20:14:14,2022-06-29 20:14:14,To GBP Rainy day,1.50,0.00,GBP,COMPLETED,33379.59
TRANSFER,Deposit,2022-06-29 20:35:58,2022-06-29 20:35:58,To GBP Rainy day,1.50,0.00,GBP,COMPLETED,33381.09
TRANSFER,Deposit,2022-06-30 02:32:23,2022-06-30 02:32:23,To GBP Rainy day,2.40,0.00,GBP,COMPLETED,33383.49
TRANSFER,Deposit,2022-06-30 03:15:11,2022-06-30 03:15:11,To GBP Rainy day,3.00,0.00,GBP,COMPLETED,33386.49
TRANSFER,Deposit,2022-06-30 04:56:42,2022-06-30 04:56:42,To GBP Rainy day,0.03,0.00,GBP,COMPLETED,33386.52
TRANSFER,Deposit,2022-06-30 07:06:03,2022-06-30 07:06:03,To GBP Rainy day,0.03,0.00,GBP,COMPLETED,33386.55
TRANSFER,Deposit,2022-06-30 07:06:31,2022-06-30 07:06:31,To GBP Rainy day,0.03,0.00,GBP,COMPLETED,33386.58
TRANSFER,Deposit,2022-06-30 07:08:06,2022-06-30 07:08:06,To GBP Rainy day,5.00,0.00,GBP,COMPLETED,33391.58
TRANSFER,Deposit,2022-06-30 09:26:25,2022-06-30 09:26:25,To GBP Rainy day,1.95,0.00,GBP,COMPLETED,33393.53
TRANSFER,Deposit,2022-06-30 11:11:36,2022-06-30 11:11:36,To GBP Rainy day,0.03,0.00,GBP,COMPLETED,33393.56
TRANSFER,Deposit,2022-06-30 11:26:33,2022-06-30 11:26:33,To GBP Rainy day,1.50,0.00,GBP,COMPLETED,33395.06
TRANSFER,Deposit,2022-06-30 11:38:52,2022-06-30 11:38:52,To GBP Rainy day,1.35,0.00,GBP,COMPLETED,33396.41
TRANSFER,Deposit,2022-06-30 11:57:30,2022-06-30 11:57:30,To GBP Savings,23000.00,0.00,GBP,COMPLETED,56396.41
TRANSFER,Deposit,2022-06-30 12:21:54,2022-06-30 12:21:54,To GBP,-2000.00,0.00,GBP,COMPLETED,54396.41
TRANSFER,Deposit,2022-06-30 15:29:38,2022-06-30 15:29:38,To GBP Rainy day,1.80,0.00,GBP,COMPLETED,54398.21
TRANSFER,Deposit,2022-06-30 18:51:07,2022-06-30 18:51:07,To GBP Rainy day,1.71,0.00,GBP,COMPLETED,54399.92
TRANSFER,Deposit,2022-06-30 18:56:14,2022-06-30 18:56:14,To GBP Rainy day,1.50,0.00,GBP,COMPLETED,54401.42
TRANSFER,Deposit,2022-06-30 19:15:26,2022-06-30 19:15:26,To GBP Rainy day,2.70,0.00,GBP,COMPLETED,54404.12
TRANSFER,Deposit,2022-07-01 07:13:33,2022-07-01 07:13:33,To GBP Rainy day,5.00,0.00,GBP,COMPLETED,54409.12
TRANSFER,Deposit,2022-07-01 18:43:10,2022-07-01 18:43:10,To GBP Rainy day,1.95,0.00,GBP,COMPLETED,54411.07
TRANSFER,Deposit,2022-07-02 07:06:05,2022-07-02 07:06:05,To GBP Rainy day,5.00,0.00,GBP,COMPLETED,54416.07
TRANSFER,Deposit,2022-07-03 07:05:50,2022-07-03 07:05:50,To GBP Rainy day,5.00,0.00,GBP,COMPLETED,54421.07
TRANSFER,Deposit,2022-07-04 07:24:19,2022-07-04 07:24:19,To GBP Rainy day,5.00,0.00,GBP,COMPLETED,54426.07
TRANSFER,Deposit,2022-07-05 07:05:42,2022-07-05 07:05:42,To GBP Rainy day,5.00,0.00,GBP,COMPLETED,54431.07
TRANSFER,Deposit,2022-07-06 07:05:22,2022-07-06 07:05:22,To GBP Rainy day,5.00,0.00,GBP,COMPLETED,54436.07
TRANSFER,Deposit,2022-07-06 11:39:27,2022-07-06 11:39:27,To GBP Rainy day,0.03,0.00,GBP,COMPLETED,54436.10
TRANSFER,Deposit,2022-07-06 21:03:35,2022-07-06 21:03:35,To GBP Rainy day,2.40,0.00,GBP,COMPLETED,54438.50
TRANSFER,Deposit,2022-07-06 21:16:16,2022-07-06 21:16:16,To GBP Rainy day,0.60,0.00,GBP,COMPLETED,54439.10
TRANSFER,Deposit,2022-07-06 21:31:04,2022-07-06 21:31:04,To GBP Rainy day,3.00,0.00,GBP,COMPLETED,54442.10
TRANSFER,Deposit,2022-07-07 07:06:26,2022-07-07 07:06:26,To GBP Rainy day,5.00,0.00,GBP,COMPLETED,54447.10
TRANSFER,Deposit,2022-07-08 01:32:41,2022-07-08 01:32:41,To GBP Rainy day,1.20,0.00,GBP,COMPLETED,54448.30
TRANSFER,Deposit,2022-07-08 07:08:36,2022-07-08 07:08:36,To GBP Rainy day,5.00,0.00,GBP,COMPLETED,54453.30
TRANSFER,Deposit,2022-07-08 22:28:19,2022-07-08 22:28:19,To GBP Rainy day,3.00,0.00,GBP,COMPLETED,54456.30
TRANSFER,Deposit,2022-07-09 01:32:11,2022-07-09 01:32:11,To GBP Rainy day,0.60,0.00,GBP,COMPLETED,54456.90
TRANSFER,Deposit,2022-07-09 07:05:30,2022-07-09 07:05:30,To GBP Rainy day,5.00,0.00,GBP,COMPLETED,54461.90
TRANSFER,Deposit,2022-07-10 07:06:13,2022-07-10 07:06:13,To GBP Rainy day,5.00,0.00,GBP,COMPLETED,54466.90
TRANSFER,Deposit,2022-07-11 07:24:38,2022-07-11 07:24:38,To GBP Rainy day,5.00,0.00,GBP,COMPLETED,54471.90
TRANSFER,Deposit,2022-07-11 11:26:13,2022-07-11 11:26:13,To GBP Rainy day,0.18,0.00,GBP,COMPLETED,54472.08
TRANSFER,Deposit,2022-07-11 12:09:13,2022-07-11 12:09:13,To GBP Rainy day,0.03,0.00,GBP,COMPLETED,54472.11
TRANSFER,Deposit,2022-07-11 19:47:03,2022-07-11 19:47:03,To GBP Rainy day,3.00,0.00,GBP,COMPLETED,54475.11
TRANSFER,Deposit,2022-07-12 07:05:06,2022-07-12 07:05:06,To GBP Rainy day,5.00,0.00,GBP,COMPLETED,54480.11
TRANSFER,Deposit,2022-07-12 19:45:38,2022-07-12 19:45:38,To GBP Rainy day,2.25,0.00,GBP,COMPLETED,54482.36
TRANSFER,Deposit,2022-07-13 07:05:11,2022-07-13 07:05:11,To GBP Rainy day,5.00,0.00,GBP,COMPLETED,54487.36
TRANSFER,Deposit,2022-07-14 07:06:15,2022-07-14 07:06:15,To GBP Rainy day,5.00,0.00,GBP,COMPLETED,54492.36
TRANSFER,Deposit,2022-07-15 07:09:14,2022-07-15 07:09:14,To GBP Rainy day,5.00,0.00,GBP,COMPLETED,54497.36
TRANSFER,Deposit,2022-07-16 01:28:04,2022-07-16 01:28:04,To GBP Rainy day,2.40,0.00,GBP,COMPLETED,54499.76
TRANSFER,Deposit,2022-07-16 07:05:38,2022-07-16 07:05:38,To GBP Rainy day,5.00,0.00,GBP,COMPLETED,54504.76
TRANSFER,Deposit,2022-07-17 07:05:24,2022-07-17 07:05:24,To GBP Rainy day,5.00,0.00,GBP,COMPLETED,54509.76
TRANSFER,Deposit,2022-07-18 07:24:44,2022-07-18 07:24:44,To GBP Rainy day,5.00,0.00,GBP,COMPLETED,54514.76
TRANSFER,Deposit,2022-07-18 08:34:43,2022-07-18 08:34:43,To GBP,-164.76,0.00,GBP,COMPLETED,54350.00
TRANSFER,Deposit,2022-07-18 08:35:01,2022-07-18 08:35:01,To GBP,-1000.00,0.00,GBP,COMPLETED,53350.00
TRANSFER,Deposit,2022-07-18 22:58:47,2022-07-18 22:58:47,To GBP Rainy day,3.00,0.00,GBP,COMPLETED,53353.00
TRANSFER,Deposit,2022-07-19 01:18:12,2022-07-19 01:18:12,To GBP Rainy day,0.90,0.00,GBP,COMPLETED,53353.90
TRANSFER,Deposit,2022-07-19 07:04:56,2022-07-19 07:04:56,To GBP Rainy day,5.00,0.00,GBP,COMPLETED,53358.90
TRANSFER,Deposit,2022-07-20 07:05:29,2022-07-20 07:05:29,To GBP Rainy day,5.00,0.00,GBP,COMPLETED,53363.90
TRANSFER,Deposit,2022-07-21 07:06:18,2022-07-21 07:06:18,To GBP Rainy day,5.00,0.00,GBP,COMPLETED,53368.90
TRANSFER,Deposit,2022-07-21 23:01:00,2022-07-21 23:01:00,To GBP Rainy day,3.00,0.00,GBP,COMPLETED,53371.90
TRANSFER,Deposit,2022-07-22 03:17:05,2022-07-22 03:17:05,To GBP Rainy day,0.03,0.00,GBP,COMPLETED,53371.93
TRANSFER,Deposit,2022-07-22 07:08:26,2022-07-22 07:08:26,To GBP Rainy day,5.00,0.00,GBP,COMPLETED,53376.93
TRANSFER,Deposit,2022-07-23 01:26:15,2022-07-23 01:26:15,To GBP Rainy day,1.80,0.00,GBP,COMPLETED,53378.73
TRANSFER,Deposit,2022-07-23 07:05:27,2022-07-23 07:05:27,To GBP Rainy day,5.00,0.00,GBP,COMPLETED,53383.73
TRANSFER,Deposit,2022-07-24 07:05:21,2022-07-24 07:05:21,To GBP Rainy day,5.00,0.00,GBP,COMPLETED,53388.73
TRANSFER,Deposit,2022-07-24 23:37:00,2022-07-24 23:37:00,To GBP Rainy day,0.66,0.00,GBP,COMPLETED,53389.39
TRANSFER,Deposit,2022-07-25 07:25:18,2022-07-25 07:25:18,To GBP Rainy day,5.00,0.00,GBP,COMPLETED,53394.39
TRANSFER,Deposit,2022-07-26 07:05:21,2022-07-26 07:05:21,To GBP Rainy day,5.00,0.00,GBP,COMPLETED,53399.39
TRANSFER,Deposit,2022-07-27 01:27:39,2022-07-27 01:27:39,To GBP Rainy day,2.40,0.00,GBP,COMPLETED,53401.79
TRANSFER,Deposit,2022-07-27 13:04:47,2022-07-27 13:04:47,To GBP Rainy day,5.00,0.00,GBP,COMPLETED,53406.79
TRANSFER,Deposit,2022-07-28 07:06:52,2022-07-28 07:06:52,To GBP Rainy day,5.00,0.00,GBP,COMPLETED,53411.79
TRANSFER,Deposit,2022-07-28 10:15:01,2022-07-28 10:15:01,To GBP,-2000.00,0.00,GBP,COMPLETED,51411.79
TRANSFER,Deposit,2022-07-29 06:09:01,2022-07-29 06:09:01,To GBP Rainy day,0.57,0.00,GBP,COMPLETED,51412.36
TRANSFER,Deposit,2022-07-29 07:08:43,2022-07-29 07:08:43,To GBP Rainy day,5.00,0.00,GBP,COMPLETED,51417.36
TRANSFER,Deposit,2022-07-29 13:35:16,2022-07-29 13:35:16,To GBP Rainy day,0.03,0.00,GBP,COMPLETED,51417.39
TRANSFER,Deposit,2022-07-30 03:07:55,2022-07-30 03:07:55,To GBP Rainy day,3.00,0.00,GBP,COMPLETED,51420.39
TRANSFER,Deposit,2022-07-30 04:01:53,2022-07-30 04:01:53,To GBP Rainy day,0.03,0.00,GBP,COMPLETED,51420.42
TRANSFER,Deposit,2022-07-30 07:06:01,2022-07-30 07:06:01,To GBP Rainy day,5.00,0.00,GBP,COMPLETED,51425.42
TRANSFER,Deposit,2022-07-31 07:06:20,2022-07-31 07:06:20,To GBP Rainy day,5.00,0.00,GBP,COMPLETED,51430.42
TRANSFER,Deposit,2022-08-01 07:30:58,2022-08-01 07:30:58,To GBP Rainy day,5.00,0.00,GBP,COMPLETED,51435.42
TRANSFER,Deposit,2022-08-02 07:05:42,2022-08-02 07:05:42,To GBP Rainy day,5.00,0.00,GBP,COMPLETED,51440.42
EXCHANGE,Deposit,2022-08-02 08:00:23,2022-08-02 08:00:23,Exchanged to GBP Rainy day,1.30,0.00,GBP,COMPLETED,51441.72
TRANSFER,Deposit,2022-08-03 07:05:47,2022-08-03 07:05:47,To GBP Rainy day,5.00,0.00,GBP,COMPLETED,51446.72
TRANSFER,Deposit,2022-08-03 19:00:58,2022-08-03 19:00:58,To GBP Rainy day,2.70,0.00,GBP,COMPLETED,51449.42
TRANSFER,Deposit,2022-08-04 01:25:18,2022-08-04 01:25:18,To GBP Rainy day,1.20,0.00,GBP,COMPLETED,51450.62
TRANSFER,Deposit,2022-08-04 07:06:37,2022-08-04 07:06:37,To GBP Rainy day,5.00,0.00,GBP,COMPLETED,51455.62
TRANSFER,Deposit,2022-08-04 10:10:44,2022-08-04 10:10:44,To GBP Rainy day,1.08,0.00,GBP,COMPLETED,51456.70
TRANSFER,Deposit,2022-08-04 13:30:59,2022-08-04 13:30:59,To GBP,-2500.00,0.00,GBP,COMPLETED,48956.70
TRANSFER,Deposit,2022-08-05 07:09:22,2022-08-05 07:09:22,To GBP Rainy day,5.00,0.00,GBP,COMPLETED,48961.70
TRANSFER,Deposit,2022-08-05 13:43:21,2022-08-05 13:43:24,Depositing savings,-15500.00,0.00,GBP,COMPLETED,33461.70
TRANSFER,Deposit,2022-08-05 13:43:21,2022-08-05 13:43:26,Depositing savings,-111.70,0.00,GBP,COMPLETED,33350.00
TRANSFER,Deposit,2022-08-05 13:43:21,2022-08-05 13:43:26,Depositing savings,-33350.00,0.00,GBP,COMPLETED,0.00
TRANSFER,Deposit,2022-08-28 15:57:15,2022-08-28 15:57:15,Withdrawing savings,31369.91,0.00,GBP,COMPLETED,31369.91
TRANSFER,Deposit,2022-08-28 15:57:15,2022-08-28 15:57:15,Withdrawing savings,23509.97,0.00,GBP,COMPLETED,54879.88
TRANSFER,Deposit,2022-08-28 15:57:15,2022-08-28 15:57:15,Withdrawing savings,290.45,0.00,GBP,COMPLETED,55170.33
TRANSFER,Deposit,2022-08-28 15:57:15,2022-08-28 15:57:16,Depositing savings,-31369.91,0.00,GBP,COMPLETED,23800.42
TRANSFER,Deposit,2022-08-28 15:57:16,2022-08-28 15:57:16,Depositing savings,-23509.97,0.00,GBP,COMPLETED,290.45
TRANSFER,Deposit,2022-08-28 16:04:23,2022-08-28 16:04:23,Depositing savings,-290.45,0.00,GBP,COMPLETED,0.00
TRANSFER,Savings,2022-08-26 14:58:33,2022-08-26 14:58:33,To GBP Home,400000.00,0.00,GBP,COMPLETED,400000.00
TRANSFER,Savings,2022-08-28 15:58:21,2022-08-28 15:58:21,To GBP,-85000.00,0.00,GBP,COMPLETED,315000.00
TRANSFER,Savings,2022-08-28 15:59:39,2022-08-28 15:59:39,To GBP Home,85000.00,0.00,GBP,COMPLETED,400000.00
CASHBACK,Savings,2022-08-28 18:14:06,2022-08-29 12:06:54,Metal Cashback,0.01,0.00,GBP,COMPLETED,400000.01
CASHBACK,Savings,2022-08-29 13:44:14,2022-08-30 09:47:14,Metal Cashback,0.01,0.00,GBP,COMPLETED,400000.02
CASHBACK,Savings,2022-08-29 16:28:57,2022-08-30 09:55:14,Metal Cashback,0.03,0.00,GBP,COMPLETED,400000.05
CASHBACK,Savings,2022-08-29 14:32:16,2022-08-30 10:37:49,Metal Cashback,0.07,0.00,GBP,COMPLETED,400000.12
CASHBACK,Savings,2022-08-29 11:46:24,2022-08-30 10:54:46,Metal Cashback,0.01,0.00,GBP,COMPLETED,400000.13
CASHBACK,Savings,2022-08-29 16:55:01,2022-08-30 11:15:20,Metal Cashback,0.09,0.00,GBP,COMPLETED,400000.22
CASHBACK,Savings,2022-08-29 11:33:44,2022-08-30 12:00:03,Metal Cashback,0.03,0.00,GBP,COMPLETED,400000.25
CASHBACK,Savings,2022-08-29 17:58:07,2022-08-30 12:25:23,Metal Cashback,0.05,0.00,GBP,COMPLETED,400000.30
CASHBACK,Savings,2022-08-29 19:48:04,2022-08-30 12:32:49,Metal Cashback,0.01,0.00,GBP,COMPLETED,400000.31
CASHBACK,Savings,2022-08-29 11:37:26,2022-08-30 14:13:42,Metal Cashback,0.02,0.00,GBP,COMPLETED,400000.33
CASHBACK,Savings,2022-08-29 16:13:36,2022-08-30 14:16:02,Metal Cashback,0.03,0.00,GBP,COMPLETED,400000.36
CASHBACK,Savings,2022-08-30 05:00:21,2022-08-30 15:10:36,Metal Cashback,0.01,0.00,GBP,COMPLETED,400000.37
CASHBACK,Savings,2022-08-29 09:11:21,2022-08-30 15:22:56,Metal Cashback,0.58,0.00,GBP,COMPLETED,400000.95
CASHBACK,Savings,2022-08-30 09:51:16,2022-08-31 10:35:22,Metal Cashback,0.02,0.00,GBP,COMPLETED,400000.97
CASHBACK,Savings,2022-08-30 03:06:25,2022-08-31 11:15:05,Metal Cashback,0.05,0.00,GBP,COMPLETED,400001.02
CASHBACK,Savings,2022-08-30 20:26:06,2022-08-31 15:22:56,Metal Cashback,0.03,0.00,GBP,COMPLETED,400001.05
TRANSFER,Savings,2022-09-01 09:28:04,2022-09-01 09:28:04,To GBP,-34000.00,0.00,GBP,COMPLETED,366001.05
TRANSFER,Savings,2022-09-01 09:28:46,2022-09-01 09:28:46,To GBP Home,4000.00,0.00,GBP,COMPLETED,370001.05
CASHBACK,Savings,2022-08-31 19:07:17,2022-09-01 11:21:36,Metal Cashback,0.04,0.00,GBP,COMPLETED,370001.09
CASHBACK,Savings,2022-08-31 07:02:37,2022-09-01 15:03:08,Metal Cashback,0.20,0.00,GBP,COMPLETED,370001.29
CASHBACK,Savings,2022-08-31 11:40:12,2022-09-02 09:46:34,Metal Cashback,0.45,0.00,GBP,COMPLETED,370001.74
CASHBACK,Savings,2022-08-30 13:59:49,2022-09-02 11:45:24,Metal Cashback,0.06,0.00,GBP,COMPLETED,370001.80
CASHBACK,Savings,2022-09-01 17:17:12,2022-09-02 12:01:29,Metal Cashback,0.01,0.00,GBP,COMPLETED,370001.81
CASHBACK,Savings,2022-09-01 11:14:23,2022-09-02 14:40:02,Metal Cashback,0.03,0.00,GBP,COMPLETED,370001.84
CASHBACK,Savings,2022-09-01 12:28:38,2022-09-02 14:42:20,Metal Cashback,0.03,0.00,GBP,COMPLETED,370001.87
CASHBACK,Savings,2022-09-01 15:03:44,2022-09-02 14:46:17,Metal Cashback,0.27,0.00,GBP,COMPLETED,370002.14
CASHBACK,Savings,2022-09-01 17:41:37,2022-09-02 14:48:10,Metal Cashback,0.05,0.00,GBP,COMPLETED,370002.19
CASHBACK,Savings,2022-09-01 05:37:57,2022-09-02 15:54:29,Metal Cashback,0.02,0.00,GBP,COMPLETED,370002.21
CASHBACK,Savings,2022-09-01 09:07:33,2022-09-03 09:25:05,Metal Cashback,0.01,0.00,GBP,COMPLETED,370002.22
CASHBACK,Savings,2022-09-02 12:29:10,2022-09-03 12:28:58,Metal Cashback,0.03,0.00,GBP,COMPLETED,370002.25
CASHBACK,Savings,2022-09-02 18:59:49,2022-09-03 12:38:03,Metal Cashback,0.01,0.00,GBP,COMPLETED,370002.26
CASHBACK,Savings,2022-09-02 19:11:55,2022-09-03 12:38:10,Metal Cashback,0.09,0.00,GBP,COMPLETED,370002.35
CASHBACK,Savings,2022-09-02 18:23:31,2022-09-03 14:42:13,Metal Cashback,0.01,0.00,GBP,COMPLETED,370002.36
CASHBACK,Savings,2022-09-03 18:18:51,2022-09-04 12:01:16,Metal Cashback,0.01,0.00,GBP,COMPLETED,370002.37
CASHBACK,Savings,2022-09-03 18:04:32,2022-09-04 12:01:16,Metal Cashback,0.02,0.00,GBP,COMPLETED,370002.39
CASHBACK,Savings,2022-09-03 21:05:53,2022-09-04 13:40:43,Metal Cashback,0.02,0.00,GBP,COMPLETED,370002.41
CASHBACK,Savings,2022-09-03 13:26:47,2022-09-04 14:07:24,Metal Cashback,0.01,0.00,GBP,COMPLETED,370002.42
CASHBACK,Savings,2022-09-03 15:19:14,2022-09-04 14:08:27,Metal Cashback,0.01,0.00,GBP,COMPLETED,370002.43
CASHBACK,Savings,2022-09-03 11:45:41,2022-09-04 14:57:12,Metal Cashback,0.01,0.00,GBP,COMPLETED,370002.44
CASHBACK,Savings,2022-09-04 01:17:32,2022-09-05 09:14:57,Metal Cashback,0.01,0.00,GBP,COMPLETED,370002.45
CASHBACK,Savings,2022-09-04 18:35:57,2022-09-05 12:57:51,Metal Cashback,0.06,0.00,GBP,COMPLETED,370002.51
CASHBACK,Savings,2022-09-04 15:42:47,2022-09-05 13:01:26,Metal Cashback,0.04,0.00,GBP,COMPLETED,370002.55
CASHBACK,Savings,2022-09-04 16:46:22,2022-09-05 13:19:44,Metal Cashback,0.02,0.00,GBP,COMPLETED,370002.57
CASHBACK,Savings,2022-09-05 09:52:23,2022-09-06 09:53:20,Metal Cashback,0.02,0.00,GBP,COMPLETED,370002.59
CASHBACK,Savings,2022-09-05 18:52:11,2022-09-06 11:59:38,Metal Cashback,0.32,0.00,GBP,COMPLETED,370002.91
CASHBACK,Savings,2022-09-05 20:18:47,2022-09-06 12:54:36,Metal Cashback,0.05,0.00,GBP,COMPLETED,370002.96
CASHBACK,Savings,2022-09-05 19:36:02,2022-09-06 23:07:54,Metal Cashback,0.39,0.00,GBP,COMPLETED,370003.35
CASHBACK,Savings,2022-09-06 10:32:09,2022-09-07 09:32:40,Metal Cashback,0.02,0.00,GBP,COMPLETED,370003.37
CASHBACK,Savings,2022-09-07 01:24:13,2022-09-07 10:54:42,Metal Cashback,0.01,0.00,GBP,COMPLETED,370003.38
CASHBACK,Savings,2022-09-06 22:33:37,2022-09-07 12:39:04,Metal Cashback,0.02,0.00,GBP,COMPLETED,370003.40
CASHBACK,Savings,2022-09-06 13:38:28,2022-09-07 13:31:54,Metal Cashback,0.01,0.00,GBP,COMPLETED,370003.41
CASHBACK,Savings,2022-09-06 13:03:34,2022-09-07 15:02:04,Metal Cashback,0.05,0.00,GBP,COMPLETED,370003.46
CASHBACK,Savings,2022-09-06 11:39:27,2022-09-07 17:54:21,Metal Cashback,0.01,0.00,GBP,COMPLETED,370003.47
CASHBACK,Savings,2022-09-07 15:22:54,2022-09-08 10:08:08,Metal Cashback,0.02,0.00,GBP,COMPLETED,370003.49
CASHBACK,Savings,2022-09-07 15:40:45,2022-09-08 14:01:43,Metal Cashback,0.01,0.00,GBP,COMPLETED,370003.50
CASHBACK,Savings,2022-09-07 12:20:49,2022-09-08 15:06:49,Metal Cashback,0.01,0.00,GBP,COMPLETED,370003.51
CASHBACK,Savings,2022-09-08 01:23:09,2022-09-08 18:07:05,Metal Cashback,0.01,0.00,GBP,COMPLETED,370003.52
CASHBACK,Savings,2022-09-08 15:42:35,2022-09-09 09:35:42,Metal Cashback,0.02,0.00,GBP,COMPLETED,370003.54
CASHBACK,Savings,2022-09-07 20:17:17,2022-09-09 12:11:44,Metal Cashback,0.01,0.00,GBP,COMPLETED,370003.55
CASHBACK,Savings,2022-09-07 20:33:48,2022-09-09 12:11:44,Metal Cashback,0.01,0.00,GBP,COMPLETED,370003.56
CASHBACK,Savings,2022-09-08 19:46:46,2022-09-10 10:05:53,Metal Cashback,0.03,0.00,GBP,COMPLETED,370003.59
CASHBACK,Savings,2022-09-09 12:42:11,2022-09-10 10:50:25,Metal Cashback,0.02,0.00,GBP,COMPLETED,370003.61
CASHBACK,Savings,2022-09-09 19:07:20,2022-09-10 11:22:40,Metal Cashback,0.06,0.00,GBP,COMPLETED,370003.67
CASHBACK,Savings,2022-09-09 12:29:13,2022-09-10 12:37:11,Metal Cashback,0.10,0.00,GBP,COMPLETED,370003.77
CASHBACK,Savings,2022-09-10 15:03:17,2022-09-11 11:39:17,Metal Cashback,0.03,0.00,GBP,COMPLETED,370003.80
CASHBACK,Savings,2022-09-10 12:59:15,2022-09-11 12:53:53,Metal Cashback,0.04,0.00,GBP,COMPLETED,370003.84
CASHBACK,Savings,2022-09-10 15:08:43,2022-09-11 23:58:17,Metal Cashback,0.01,0.00,GBP,COMPLETED,370003.85
CASHBACK,Savings,2022-09-11 10:03:03,2022-09-12 14:31:44,Metal Cashback,0.01,0.00,GBP,COMPLETED,370003.86
CASHBACK,Savings,2022-09-12 09:04:40,2022-09-13 09:56:49,Metal Cashback,0.02,0.00,GBP,COMPLETED,370003.88
CASHBACK,Savings,2022-09-12 07:11:39,2022-09-13 10:42:58,Metal Cashback,0.12,0.00,GBP,COMPLETED,370004.00
CASHBACK,Savings,2022-09-12 19:23:04,2022-09-13 10:52:23,Metal Cashback,0.01,0.00,GBP,COMPLETED,370004.01
CASHBACK,Savings,2022-09-12 18:54:09,2022-09-13 11:09:08,Metal Cashback,0.06,0.00,GBP,COMPLETED,370004.07
CASHBACK,Savings,2022-09-13 08:26:03,2022-09-14 09:47:33,Metal Cashback,0.02,0.00,GBP,COMPLETED,370004.09
CASHBACK,Savings,2022-09-13 18:29:48,2022-09-14 10:52:46,Metal Cashback,0.03,0.00,GBP,COMPLETED,370004.12
CASHBACK,Savings,2022-09-13 18:26:20,2022-09-14 16:17:30,Metal Cashback,0.02,0.00,GBP,COMPLETED,370004.14
CASHBACK,Savings,2022-09-14 09:25:41,2022-09-15 10:25:39,Metal Cashback,0.02,0.00,GBP,COMPLETED,370004.16
CASHBACK,Savings,2022-09-15 19:34:58,2022-09-16 10:52:27,Metal Cashback,0.03,0.00,GBP,COMPLETED,370004.19
CASHBACK,Savings,2022-09-15 13:36:05,2022-09-16 14:00:01,Metal Cashback,0.01,0.00,GBP,COMPLETED,370004.20
CASHBACK,Savings,2022-09-15 09:34:04,2022-09-16 15:39:04,Metal Cashback,0.03,0.00,GBP,COMPLETED,370004.23
CASHBACK,Savings,2022-09-15 12:46:33,2022-09-16 16:18:36,Metal Cashback,0.01,0.00,GBP,COMPLETED,370004.24
CASHBACK,Savings,2022-09-15 18:29:00,2022-09-16 16:19:22,Metal Cashback,0.07,0.00,GBP,COMPLETED,370004.31
CASHBACK,Savings,2022-09-16 22:58:38,2022-09-17 12:00:03,Metal Cashback,0.03,0.00,GBP,COMPLETED,370004.34
CASHBACK,Savings,2022-09-16 20:44:12,2022-09-17 12:07:15,Metal Cashback,0.03,0.00,GBP,COMPLETED,370004.37
CASHBACK,Savings,2022-09-16 16:37:57,2022-09-17 14:06:14,Metal Cashback,0.02,0.00,GBP,COMPLETED,370004.39
CASHBACK,Savings,2022-09-17 13:29:44,2022-09-18 12:42:15,Metal Cashback,0.01,0.00,GBP,COMPLETED,370004.40
CASHBACK,Savings,2022-09-17 17:12:59,2022-09-18 14:17:31,Metal Cashback,0.05,0.00,GBP,COMPLETED,370004.45
CASHBACK,Savings,2022-09-17 17:17:15,2022-09-18 16:23:43,Metal Cashback,0.02,0.00,GBP,COMPLETED,370004.47
CASHBACK,Savings,2022-09-17 20:27:54,2022-09-18 16:33:22,Metal Cashback,0.01,0.00,GBP,COMPLETED,370004.48
CASHBACK,Savings,2022-09-17 19:05:16,2022-09-19 09:29:12,Metal Cashback,0.20,0.00,GBP,COMPLETED,370004.68
CASHBACK,Savings,2022-09-17 22:44:35,2022-09-19 09:29:12,Metal Cashback,0.09,0.00,GBP,COMPLETED,370004.77
CASHBACK,Savings,2022-09-17 20:45:16,2022-09-19 09:33:13,Metal Cashback,0.01,0.00,GBP,COMPLETED,370004.78
CASHBACK,Savings,2022-09-17 21:17:19,2022-09-19 09:33:14,Metal Cashback,0.01,0.00,GBP,COMPLETED,370004.79
CASHBACK,Savings,2022-09-18 16:54:50,2022-09-19 12:55:36,Metal Cashback,0.06,0.00,GBP,COMPLETED,370004.85
CASHBACK,Savings,2022-09-18 10:24:20,2022-09-19 13:09:11,Metal Cashback,0.02,0.00,GBP,COMPLETED,370004.87
CASHBACK,Savings,2022-09-18 19:50:54,2022-09-19 17:54:15,Metal Cashback,0.11,0.00,GBP,COMPLETED,370004.98
CASHBACK,Savings,2022-09-13 12:22:21,2022-09-19 19:14:24,Metal Cashback,0.14,0.00,GBP,COMPLETED,370005.12
CASHBACK,Savings,2022-09-19 08:33:34,2022-09-20 09:46:56,Metal Cashback,0.02,0.00,GBP,COMPLETED,370005.14
CASHBACK,Savings,2022-09-16 17:06:22,2022-09-20 10:25:06,Metal Cashback,0.05,0.00,GBP,COMPLETED,370005.19
CASHBACK,Savings,2022-09-19 23:04:29,2022-09-20 11:52:59,Metal Cashback,0.02,0.00,GBP,COMPLETED,370005.21
CASHBACK,Savings,2022-09-19 17:44:28,2022-09-20 19:47:42,Metal Cashback,0.87,0.00,GBP,COMPLETED,370006.08
CASHBACK,Savings,2022-09-21 01:24:40,2022-09-21 10:52:15,Metal Cashback,0.01,0.00,GBP,COMPLETED,370006.09
CASHBACK,Savings,2022-09-19 14:51:19,2022-09-21 11:35:45,Metal Cashback,0.01,0.00,GBP,COMPLETED,370006.10
CASHBACK,Savings,2022-09-20 14:16:13,2022-09-21 12:00:40,Metal Cashback,0.02,0.00,GBP,COMPLETED,370006.12
CASHBACK,Savings,2022-09-20 16:56:45,2022-09-21 14:56:08,Metal Cashback,0.01,0.00,GBP,COMPLETED,370006.13
CASHBACK,Savings,2022-09-20 12:21:18,2022-09-22 10:30:40,Metal Cashback,0.05,0.00,GBP,COMPLETED,370006.18
CASHBACK,Savings,2022-09-21 18:31:23,2022-09-22 11:48:13,Metal Cashback,0.03,0.00,GBP,COMPLETED,370006.21
CASHBACK,Savings,2022-09-20 21:19:56,2022-09-22 12:20:53,Metal Cashback,0.01,0.00,GBP,COMPLETED,370006.22
CASHBACK,Savings,2022-09-21 18:25:34,2022-09-22 13:40:29,Metal Cashback,0.03,0.00,GBP,COMPLETED,370006.25
CASHBACK,Savings,2022-09-22 10:30:41,2022-09-23 10:42:35,Metal Cashback,0.02,0.00,GBP,COMPLETED,370006.27
CASHBACK,Savings,2022-09-22 18:45:41,2022-09-23 13:34:06,Metal Cashback,0.02,0.00,GBP,COMPLETED,370006.29
CASHBACK,Savings,2022-09-22 03:17:37,2022-09-23 20:55:28,Metal Cashback,0.01,0.00,GBP,COMPLETED,370006.30
CASHBACK,Savings,2022-09-23 14:35:39,2022-09-24 10:27:34,Metal Cashback,0.02,0.00,GBP,COMPLETED,370006.32
CASHBACK,Savings,2022-09-23 10:53:09,2022-09-24 11:42:43,Metal Cashback,0.02,0.00,GBP,COMPLETED,370006.34
CASHBACK,Savings,2022-09-23 17:45:29,2022-09-24 13:48:45,Metal Cashback,0.09,0.00,GBP,COMPLETED,370006.43
CASHBACK,Savings,2022-09-23 13:01:40,2022-09-24 14:13:23,Metal Cashback,0.01,0.00,GBP,COMPLETED,370006.44
CASHBACK,Savings,2022-09-25 14:51:38,2022-09-26 09:26:29,Metal Cashback,0.03,0.00,GBP,COMPLETED,370006.47
CASHBACK,Savings,2022-09-25 20:36:19,2022-09-26 10:30:28,Metal Cashback,0.02,0.00,GBP,COMPLETED,370006.49
CASHBACK,Savings,2022-09-25 16:22:11,2022-09-26 10:32:33,Metal Cashback,0.03,0.00,GBP,COMPLETED,370006.52
CASHBACK,Savings,2022-09-26 15:16:17,2022-09-27 11:09:07,Metal Cashback,0.01,0.00,GBP,COMPLETED,370006.53
CASHBACK,Savings,2022-09-26 15:12:52,2022-09-27 13:12:10,Metal Cashback,0.04,0.00,GBP,COMPLETED,370006.57
CASHBACK,Savings,2022-09-26 19:24:12,2022-09-27 13:13:02,Metal Cashback,0.01,0.00,GBP,COMPLETED,370006.58
CASHBACK,Savings,2022-09-27 18:24:07,2022-09-28 10:16:53,Metal Cashback,0.03,0.00,GBP,COMPLETED,370006.61
CASHBACK,Savings,2022-09-27 23:15:09,2022-09-28 12:19:00,Metal Cashback,0.29,0.00,GBP,COMPLETED,370006.90
CASHBACK,Savings,2022-09-27 17:27:26,2022-09-28 12:31:16,Metal Cashback,0.22,0.00,GBP,COMPLETED,370007.12
CASHBACK,Savings,2022-09-27 13:08:20,2022-09-28 13:45:21,Metal Cashback,0.01,0.00,GBP,COMPLETED,370007.13
CASHBACK,Savings,2022-09-28 14:05:50,2022-09-29 11:00:29,Metal Cashback,0.01,0.00,GBP,COMPLETED,370007.14
CASHBACK,Savings,2022-09-28 18:07:57,2022-09-29 13:49:12,Metal Cashback,0.02,0.00,GBP,COMPLETED,370007.16
CASHBACK,Savings,2022-09-28 13:09:05,2022-09-30 10:28:56,Metal Cashback,0.08,0.00,GBP,COMPLETED,370007.24
CASHBACK,Savings,2022-09-29 13:34:21,2022-09-30 10:30:48,Metal Cashback,0.01,0.00,GBP,COMPLETED,370007.25
CASHBACK,Savings,2022-09-29 13:01:16,2022-09-30 10:38:52,Metal Cashback,0.01,0.00,GBP,COMPLETED,370007.26
CASHBACK,Savings,2022-09-29 10:57:42,2022-09-30 11:59:14,Metal Cashback,0.40,0.00,GBP,COMPLETED,370007.66
CASHBACK,Savings,2022-09-29 10:36:27,2022-09-30 11:59:34,Metal Cashback,5.62,0.00,GBP,COMPLETED,370013.28
CASHBACK,Savings,2022-09-29 10:41:34,2022-09-30 12:46:45,Metal Cashback,3.88,0.00,GBP,COMPLETED,370017.16
CASHBACK,Savings,2022-09-30 06:04:29,2022-10-01 01:29:00,Metal Cashback,0.01,0.00,GBP,COMPLETED,370017.17
CASHBACK,Savings,2022-09-30 18:37:09,2022-10-01 10:42:24,Metal Cashback,0.03,0.00,GBP,COMPLETED,370017.20
CASHBACK,Savings,2022-09-30 03:06:22,2022-10-01 12:31:05,Metal Cashback,0.05,0.00,GBP,COMPLETED,370017.25
CASHBACK,Savings,2022-09-30 15:20:18,2022-10-01 14:55:53,Metal Cashback,0.01,0.00,GBP,COMPLETED,370017.26
CASHBACK,Savings,2022-09-30 18:54:42,2022-10-01 15:46:55,Metal Cashback,0.03,0.00,GBP,COMPLETED,370017.29
CASHBACK,Savings,2022-09-30 16:59:49,2022-10-02 09:27:56,Metal Cashback,0.02,0.00,GBP,COMPLETED,370017.31
CASHBACK,Savings,2022-10-01 13:09:51,2022-10-02 11:43:50,Metal Cashback,0.03,0.00,GBP,COMPLETED,370017.34
CASHBACK,Savings,2022-10-01 20:01:18,2022-10-02 13:20:11,Metal Cashback,0.02,0.00,GBP,COMPLETED,370017.36
CASHBACK,Savings,2022-10-01 16:38:03,2022-10-02 15:39:06,Metal Cashback,0.01,0.00,GBP,COMPLETED,370017.37
CASHBACK,Savings,2022-10-03 19:05:36,2022-10-04 10:24:30,Metal Cashback,0.06,0.00,GBP,COMPLETED,370017.43
CASHBACK,Savings,2022-10-03 18:49:05,2022-10-04 12:58:05,Metal Cashback,0.03,0.00,GBP,COMPLETED,370017.46
CASHBACK,Savings,2022-10-03 18:40:58,2022-10-04 15:11:12,Metal Cashback,0.02,0.00,GBP,COMPLETED,370017.48
CASHBACK,Savings,2022-10-04 14:11:08,2022-10-05 09:39:16,Metal Cashback,0.01,0.00,GBP,COMPLETED,370017.49
CASHBACK,Savings,2022-10-05 11:10:15,2022-10-06 10:07:37,Metal Cashback,0.06,0.00,GBP,COMPLETED,370017.55
CASHBACK,Savings,2022-10-05 19:13:03,2022-10-06 13:32:37,Metal Cashback,0.03,0.00,GBP,COMPLETED,370017.58
CASHBACK,Savings,2022-10-05 12:58:42,2022-10-06 13:53:17,Metal Cashback,0.03,0.00,GBP,COMPLETED,370017.61
CASHBACK,Savings,2022-10-06 01:16:07,2022-10-06 16:28:58,Metal Cashback,0.01,0.00,GBP,COMPLETED,370017.62
CASHBACK,Savings,2022-10-06 09:46:15,2022-10-07 10:26:28,Metal Cashback,0.01,0.00,GBP,COMPLETED,370017.63
CASHBACK,Savings,2022-10-06 18:39:12,2022-10-07 10:35:32,Metal Cashback,0.02,0.00,GBP,COMPLETED,370017.65
CASHBACK,Savings,2022-10-06 09:56:30,2022-10-07 12:55:31,Metal Cashback,0.01,0.00,GBP,COMPLETED,370017.66
CASHBACK,Savings,2022-10-06 18:35:53,2022-10-07 14:29:15,Metal Cashback,0.03,0.00,GBP,COMPLETED,370017.69
CASHBACK,Savings,2022-10-06 22:46:03,2022-10-07 14:46:07,Metal Cashback,0.02,0.00,GBP,COMPLETED,370017.71
CASHBACK,Savings,2022-10-06 11:41:54,2022-10-07 22:48:02,Metal Cashback,0.01,0.00,GBP,COMPLETED,370017.72
CASHBACK,Savings,2022-10-07 16:05:53,2022-10-08 10:37:28,Metal Cashback,0.05,0.00,GBP,COMPLETED,370017.77
CASHBACK,Savings,2022-10-08 01:21:02,2022-10-09 00:59:11,Metal Cashback,0.01,0.00,GBP,COMPLETED,370017.78
CASHBACK,Savings,2022-10-08 16:53:22,2022-10-11 01:06:47,Metal Cashback,0.13,0.00,GBP,COMPLETED,370017.91
CASHBACK,Savings,2022-10-09 14:24:48,2022-10-11 08:06:20,Metal Cashback,0.03,0.00,GBP,COMPLETED,370017.94
CASHBACK,Savings,2022-10-10 18:32:50,2022-10-12 01:28:08,Metal Cashback,0.03,0.00,GBP,COMPLETED,370017.97
CASHBACK,Savings,2022-10-10 09:41:05,2022-10-12 03:06:14,Metal Cashback,0.01,0.00,GBP,COMPLETED,370017.98
CASHBACK,Savings,2022-10-11 11:55:28,2022-10-12 18:59:54,Metal Cashback,0.02,0.00,GBP,COMPLETED,370018.00
CASHBACK,Savings,2022-10-11 09:28:35,2022-10-12 22:42:36,Metal Cashback,0.01,0.00,GBP,COMPLETED,370018.01
CASHBACK,Savings,2022-10-11 12:49:48,2022-10-12 22:52:20,Metal Cashback,0.10,0.00,GBP,COMPLETED,370018.11
CASHBACK,Savings,2022-10-11 15:32:44,2022-10-12 23:44:23,Metal Cashback,0.02,0.00,GBP,COMPLETED,370018.13
CASHBACK,Savings,2022-10-12 21:01:43,2022-10-13 12:47:30,Metal Cashback,0.01,0.00,GBP,COMPLETED,370018.14
CASHBACK,Savings,2022-10-12 20:44:52,2022-10-13 12:47:46,Metal Cashback,0.01,0.00,GBP,COMPLETED,370018.15
CASHBACK,Savings,2022-10-12 10:30:59,2022-10-13 14:27:54,Metal Cashback,0.02,0.00,GBP,COMPLETED,370018.17
CASHBACK,Savings,2022-10-12 10:29:39,2022-10-13 16:28:14,Metal Cashback,0.01,0.00,GBP,COMPLETED,370018.18
CASHBACK,Savings,2022-10-12 14:47:13,2022-10-13 16:28:15,Metal Cashback,0.02,0.00,GBP,COMPLETED,370018.20
CASHBACK,Savings,2022-10-13 01:21:26,2022-10-13 18:29:12,Metal Cashback,0.01,0.00,GBP,COMPLETED,370018.21
CASHBACK,Savings,2022-10-13 10:49:05,2022-10-14 10:12:25,Metal Cashback,0.03,0.00,GBP,COMPLETED,370018.24
CASHBACK,Savings,2022-10-13 13:42:05,2022-10-14 12:47:52,Metal Cashback,0.02,0.00,GBP,COMPLETED,370018.26
CASHBACK,Savings,2022-10-13 10:57:19,2022-10-14 12:54:27,Metal Cashback,0.01,0.00,GBP,COMPLETED,370018.27
CASHBACK,Savings,2022-10-15 01:20:01,2022-10-15 14:32:37,Metal Cashback,0.01,0.00,GBP,COMPLETED,370018.28
CASHBACK,Savings,2022-10-15 14:50:18,2022-10-16 11:18:37,Metal Cashback,0.04,0.00,GBP,COMPLETED,370018.32
CASHBACK,Savings,2022-10-15 15:21:15,2022-10-16 19:17:59,Metal Cashback,0.04,0.00,GBP,COMPLETED,370018.36
CASHBACK,Savings,2022-10-15 11:35:49,2022-10-17 08:57:32,Metal Cashback,0.05,0.00,GBP,COMPLETED,370018.41
CASHBACK,Savings,2022-10-16 11:07:44,2022-10-17 09:07:42,Metal Cashback,0.03,0.00,GBP,COMPLETED,370018.44
CASHBACK,Savings,2022-10-16 23:06:31,2022-10-17 12:15:33,Metal Cashback,0.03,0.00,GBP,COMPLETED,370018.47
CASHBACK,Savings,2022-10-16 13:39:17,2022-10-17 13:37:30,Metal Cashback,0.02,0.00,GBP,COMPLETED,370018.49
CASHBACK,Savings,2022-10-16 21:43:55,2022-10-18 09:19:01,Metal Cashback,0.05,0.00,GBP,COMPLETED,370018.54
CASHBACK,Savings,2022-10-17 18:09:48,2022-10-19 09:46:57,Metal Cashback,0.01,0.00,GBP,COMPLETED,370018.55
CASHBACK,Savings,2022-10-18 14:40:16,2022-10-19 10:11:21,Metal Cashback,0.01,0.00,GBP,COMPLETED,370018.56
CASHBACK,Savings,2022-10-18 13:54:00,2022-10-19 14:58:15,Metal Cashback,0.01,0.00,GBP,COMPLETED,370018.57
CASHBACK,Savings,2022-10-19 17:24:19,2022-10-20 11:09:25,Metal Cashback,0.02,0.00,GBP,COMPLETED,370018.59
CASHBACK,Savings,2022-10-19 17:37:41,2022-10-20 11:09:28,Metal Cashback,0.01,0.00,GBP,COMPLETED,370018.60
CASHBACK,Savings,2022-10-19 22:54:59,2022-10-20 13:07:43,Metal Cashback,0.02,0.00,GBP,COMPLETED,370018.62
CASHBACK,Savings,2022-10-19 20:07:04,2022-10-20 14:15:19,Metal Cashback,0.01,0.00,GBP,COMPLETED,370018.63
CASHBACK,Savings,2022-10-19 11:13:41,2022-10-21 10:49:30,Metal Cashback,0.01,0.00,GBP,COMPLETED,370018.64
CASHBACK,Savings,2022-10-19 20:14:51,2022-10-21 11:16:56,Metal Cashback,0.04,0.00,GBP,COMPLETED,370018.68
CASHBACK,Savings,2022-10-19 19:30:46,2022-10-21 13:51:53,Metal Cashback,0.01,0.00,GBP,COMPLETED,370018.69
TRANSFER,Savings,2022-10-22 06:10:38,2022-10-22 06:10:38,To GBP,-18.69,0.00,GBP,COMPLETED,370000.00
CASHBACK,Savings,2022-10-21 13:14:37,2022-10-22 10:28:20,Metal Cashback,0.02,0.00,GBP,COMPLETED,370000.02
CASHBACK,Savings,2022-10-22 16:42:01,2022-10-23 10:54:25,Metal Cashback,0.05,0.00,GBP,COMPLETED,370000.07
CASHBACK,Savings,2022-10-22 13:34:09,2022-10-23 10:59:12,Metal Cashback,0.07,0.00,GBP,COMPLETED,370000.14
CASHBACK,Savings,2022-10-22 03:20:23,2022-10-23 18:39:48,Metal Cashback,0.01,0.00,GBP,COMPLETED,370000.15
CASHBACK,Savings,2022-10-23 16:03:35,2022-10-24 10:43:13,Metal Cashback,0.01,0.00,GBP,COMPLETED,370000.16
CASHBACK,Savings,2022-10-24 18:12:42,2022-10-25 12:40:56,Metal Cashback,0.03,0.00,GBP,COMPLETED,370000.19
CASHBACK,Savings,2022-10-24 11:17:07,2022-10-25 13:41:33,Metal Cashback,0.03,0.00,GBP,COMPLETED,370000.22
CASHBACK,Savings,2022-10-24 20:22:46,2022-10-25 15:37:02,Metal Cashback,0.02,0.00,GBP,COMPLETED,370000.24
CASHBACK,Savings,2022-10-24 15:41:25,2022-10-25 16:06:33,Metal Cashback,0.01,0.00,GBP,COMPLETED,370000.25
CASHBACK,Savings,2022-10-25 01:15:23,2022-10-25 16:56:58,Metal Cashback,0.01,0.00,GBP,COMPLETED,370000.26
CASHBACK,Savings,2022-10-24 15:12:39,2022-10-26 00:02:55,Metal Cashback,0.38,0.00,GBP,COMPLETED,370000.64
CASHBACK,Savings,2022-10-26 01:19:08,2022-10-26 15:55:18,Metal Cashback,0.01,0.00,GBP,COMPLETED,370000.65
TRANSFER,Savings,2022-10-26 16:38:46,2022-10-26 16:38:46,To GBP Home,300000.00,0.00,GBP,COMPLETED,670000.65
CASHBACK,Savings,2022-10-26 08:21:21,2022-10-27 10:13:50,Metal Cashback,0.02,0.00,GBP,COMPLETED,670000.67
CASHBACK,Savings,2022-10-26 11:59:49,2022-10-27 12:26:40,Metal Cashback,0.02,0.00,GBP,COMPLETED,670000.69
CASHBACK,Savings,2022-10-26 11:49:40,2022-10-27 13:03:30,Metal Cashback,0.03,0.00,GBP,COMPLETED,670000.72
CASHBACK,Savings,2022-10-27 16:22:05,2022-10-28 12:32:08,Metal Cashback,0.06,0.00,GBP,COMPLETED,670000.78
CASHBACK,Savings,2022-10-27 13:22:11,2022-10-28 19:06:13,Metal Cashback,0.01,0.00,GBP,COMPLETED,670000.79
CASHBACK,Savings,2022-10-28 09:18:24,2022-10-29 12:21:21,Metal Cashback,0.02,0.00,GBP,COMPLETED,670000.81
CASHBACK,Savings,2022-10-28 17:32:38,2022-10-29 13:50:28,Metal Cashback,0.01,0.00,GBP,COMPLETED,670000.82
CASHBACK,Savings,2022-10-28 20:37:24,2022-10-30 10:16:16,Metal Cashback,0.04,0.00,GBP,COMPLETED,670000.86
CASHBACK,Savings,2022-10-29 14:07:24,2022-10-30 10:26:20,Metal Cashback,0.01,0.00,GBP,COMPLETED,670000.87
CASHBACK,Savings,2022-10-28 20:04:03,2022-10-30 13:03:23,Metal Cashback,0.04,0.00,GBP,COMPLETED,670000.91
CASHBACK,Savings,2022-10-28 19:06:08,2022-10-30 13:07:02,Metal Cashback,0.08,0.00,GBP,COMPLETED,670000.99
CASHBACK,Savings,2022-10-29 12:18:43,2022-10-30 13:29:44,Metal Cashback,0.03,0.00,GBP,COMPLETED,670001.02
CASHBACK,Savings,2022-10-30 03:00:26,2022-10-30 14:35:53,Metal Cashback,0.01,0.00,GBP,COMPLETED,670001.03
CASHBACK,Savings,2022-10-29 12:35:02,2022-10-30 15:46:26,Metal Cashback,0.07,0.00,GBP,COMPLETED,670001.10
CASHBACK,Savings,2022-10-31 11:50:07,2022-11-01 13:17:07,Metal Cashback,0.01,0.00,GBP,COMPLETED,670001.11
CASHBACK,Savings,2022-10-31 20:17:42,2022-11-02 12:48:35,Metal Cashback,0.04,0.00,GBP,COMPLETED,670001.15
CASHBACK,Savings,2022-11-01 16:25:18,2022-11-02 12:49:19,Metal Cashback,0.18,0.00,GBP,COMPLETED,670001.33
CASHBACK,Savings,2022-11-01 22:21:21,2022-11-03 10:55:15,Metal Cashback,0.01,0.00,GBP,COMPLETED,670001.34
CASHBACK,Savings,2022-11-02 18:30:52,2022-11-03 13:57:43,Metal Cashback,0.01,0.00,GBP,COMPLETED,670001.35
CASHBACK,Savings,2022-11-03 15:34:04,2022-11-04 11:02:55,Metal Cashback,0.01,0.00,GBP,COMPLETED,670001.36
CASHBACK,Savings,2022-11-02 23:22:25,2022-11-04 11:06:03,Metal Cashback,0.05,0.00,GBP,COMPLETED,670001.41
CASHBACK,Savings,2022-11-04 15:34:14,2022-11-05 10:00:57,Metal Cashback,0.01,0.00,GBP,COMPLETED,670001.42
CASHBACK,Savings,2022-11-04 16:47:37,2022-11-05 14:45:07,Metal Cashback,0.01,0.00,GBP,COMPLETED,670001.43
CASHBACK,Savings,2022-11-04 16:54:29,2022-11-05 14:45:19,Metal Cashback,0.01,0.00,GBP,COMPLETED,670001.44
CASHBACK,Savings,2022-11-05 15:45:00,2022-11-06 11:46:53,Metal Cashback,0.05,0.00,GBP,COMPLETED,670001.49
CASHBACK,Savings,2022-11-04 23:37:29,2022-11-06 12:17:32,Metal Cashback,0.01,0.00,GBP,COMPLETED,670001.50
CASHBACK,Savings,2022-11-05 15:41:28,2022-11-06 12:42:48,Metal Cashback,0.01,0.00,GBP,COMPLETED,670001.51
CASHBACK,Savings,2022-11-05 22:47:27,2022-11-06 14:10:53,Metal Cashback,0.02,0.00,GBP,COMPLETED,670001.53
CASHBACK,Savings,2022-11-05 10:30:24,2022-11-06 14:45:34,Metal Cashback,0.01,0.00,GBP,COMPLETED,670001.54
CASHBACK,Savings,2022-11-06 01:10:58,2022-11-07 09:50:20,Metal Cashback,0.03,0.00,GBP,COMPLETED,670001.57
CASHBACK,Savings,2022-11-06 11:40:03,2022-11-07 19:29:56,Metal Cashback,0.01,0.00,GBP,COMPLETED,670001.58
CASHBACK,Savings,2022-11-07 17:02:16,2022-11-08 09:27:19,Metal Cashback,0.02,0.00,GBP,COMPLETED,670001.60
CASHBACK,Savings,2022-11-07 16:25:22,2022-11-08 10:34:20,Metal Cashback,0.03,0.00,GBP,COMPLETED,670001.63
CASHBACK,Savings,2022-11-07 16:36:23,2022-11-08 10:34:20,Metal Cashback,0.01,0.00,GBP,COMPLETED,670001.64
CASHBACK,Savings,2022-11-07 08:45:33,2022-11-08 12:10:00,Metal Cashback,0.02,0.00,GBP,COMPLETED,670001.66
CASHBACK,Savings,2022-11-08 18:11:25,2022-11-09 09:58:05,Metal Cashback,0.03,0.00,GBP,COMPLETED,670001.69
CASHBACK,Savings,2022-11-08 17:36:32,2022-11-09 09:58:05,Metal Cashback,0.02,0.00,GBP,COMPLETED,670001.71
CASHBACK,Savings,2022-11-07 11:37:11,2022-11-09 12:09:26,Metal Cashback,0.01,0.00,GBP,COMPLETED,670001.72
CASHBACK,Savings,2022-11-09 01:18:40,2022-11-09 13:52:12,Metal Cashback,0.01,0.00,GBP,COMPLETED,670001.73
CASHBACK,Savings,2022-11-09 11:53:00,2022-11-10 12:10:19,Metal Cashback,0.02,0.00,GBP,COMPLETED,670001.75
CASHBACK,Savings,2022-11-11 12:24:36,2022-11-12 10:17:18,Metal Cashback,0.05,0.00,GBP,COMPLETED,670001.80
CASHBACK,Savings,2022-11-14 12:27:27,2022-11-15 09:40:26,Metal Cashback,0.05,0.00,GBP,COMPLETED,670001.85
CASHBACK,Savings,2022-11-15 10:14:11,2022-11-16 09:33:01,Metal Cashback,0.01,0.00,GBP,COMPLETED,670001.86
CASHBACK,Savings,2022-11-15 22:59:30,2022-11-16 11:42:29,Metal Cashback,0.03,0.00,GBP,COMPLETED,670001.89
CASHBACK,Savings,2022-11-15 11:17:54,2022-11-17 09:49:33,Metal Cashback,0.01,0.00,GBP,COMPLETED,670001.90
CASHBACK,Savings,2022-11-17 12:21:14,2022-11-18 13:58:38,Metal Cashback,0.02,0.00,GBP,COMPLETED,670001.92
CASHBACK,Savings,2022-11-16 11:36:13,2022-11-18 14:02:36,Metal Cashback,0.01,0.00,GBP,COMPLETED,670001.93
CASHBACK,Savings,2022-11-18 11:31:15,2022-11-18 18:52:42,Metal Cashback,1.06,0.00,GBP,COMPLETED,670002.99
CASHBACK,Savings,2022-11-18 14:06:17,2022-11-19 09:23:45,Metal Cashback,0.05,0.00,GBP,COMPLETED,670003.04
CASHBACK,Savings,2022-11-18 23:11:21,2022-11-19 10:56:40,Metal Cashback,0.02,0.00,GBP,COMPLETED,670003.06
CASHBACK,Savings,2022-11-17 09:26:57,2022-11-19 11:24:19,Metal Cashback,0.02,0.00,GBP,COMPLETED,670003.08
CASHBACK,Savings,2022-11-19 19:35:39,2022-11-20 10:44:59,Metal Cashback,0.05,0.00,GBP,COMPLETED,670003.13
CASHBACK,Savings,2022-11-18 18:04:29,2022-11-20 11:41:47,Metal Cashback,0.01,0.00,GBP,COMPLETED,670003.14
CASHBACK,Savings,2022-11-18 17:49:48,2022-11-20 11:43:09,Metal Cashback,0.01,0.00,GBP,COMPLETED,670003.15
CASHBACK,Savings,2022-11-20 10:44:55,2022-11-21 09:38:26,Metal Cashback,0.04,0.00,GBP,COMPLETED,670003.19
CASHBACK,Savings,2022-11-20 17:32:46,2022-11-21 10:51:53,Metal Cashback,0.04,0.00,GBP,COMPLETED,670003.23
CASHBACK,Savings,2022-11-20 16:03:37,2022-11-21 11:24:09,Metal Cashback,0.01,0.00,GBP,COMPLETED,670003.24
CASHBACK,Savings,2022-11-21 10:03:17,2022-11-22 08:58:51,Metal Cashback,0.03,0.00,GBP,COMPLETED,670003.27
CASHBACK,Savings,2022-11-21 19:18:48,2022-11-22 09:01:43,Metal Cashback,0.04,0.00,GBP,COMPLETED,670003.31
CASHBACK,Savings,2022-11-21 07:58:46,2022-11-22 09:33:10,Metal Cashback,0.01,0.00,GBP,COMPLETED,670003.32
CASHBACK,Savings,2022-11-22 03:17:12,2022-11-22 14:16:10,Metal Cashback,0.01,0.00,GBP,COMPLETED,670003.33
CASHBACK,Savings,2022-11-22 01:15:48,2022-11-22 15:55:43,Metal Cashback,0.01,0.00,GBP,COMPLETED,670003.34
CASHBACK,Savings,2022-11-22 18:29:15,2022-11-23 09:39:40,Metal Cashback,0.01,0.00,GBP,COMPLETED,670003.35
CASHBACK,Savings,2022-11-22 11:42:56,2022-11-23 10:27:28,Metal Cashback,0.03,0.00,GBP,COMPLETED,670003.38
CASHBACK,Savings,2022-11-23 01:19:16,2022-11-23 12:03:16,Metal Cashback,0.01,0.00,GBP,COMPLETED,670003.39
CASHBACK,Savings,2022-11-22 21:15:08,2022-11-23 15:18:06,Metal Cashback,0.01,0.00,GBP,COMPLETED,670003.40
CASHBACK,Savings,2022-11-23 17:08:47,2022-11-24 09:47:37,Metal Cashback,0.04,0.00,GBP,COMPLETED,670003.44
CASHBACK,Savings,2022-11-23 11:47:28,2022-11-24 12:00:23,Metal Cashback,0.06,0.00,GBP,COMPLETED,670003.50
CASHBACK,Savings,2022-11-25 17:48:20,2022-11-26 10:03:05,Metal Cashback,0.05,0.00,GBP,COMPLETED,670003.55
CASHBACK,Savings,2022-11-25 15:05:48,2022-11-26 15:57:15,Metal Cashback,0.16,0.00,GBP,COMPLETED,670003.71
CASHBACK,Savings,2022-11-26 17:24:47,2022-11-27 11:13:38,Metal Cashback,0.19,0.00,GBP,COMPLETED,670003.90
CASHBACK,Savings,2022-11-26 16:32:19,2022-11-27 11:16:19,Metal Cashback,0.06,0.00,GBP,COMPLETED,670003.96
CASHBACK,Savings,2022-11-28 22:01:28,2022-11-29 09:47:34,Metal Cashback,0.03,0.00,GBP,COMPLETED,670003.99
CASHBACK,Savings,2022-11-28 15:28:20,2022-11-29 11:19:35,Metal Cashback,0.05,0.00,GBP,COMPLETED,670004.04
CASHBACK,Savings,2022-11-29 13:09:55,2022-11-30 09:18:49,Metal Cashback,0.01,0.00,GBP,COMPLETED,670004.05
CASHBACK,Savings,2022-11-29 13:29:46,2022-11-30 10:42:44,Metal Cashback,0.02,0.00,GBP,COMPLETED,670004.07
CASHBACK,Savings,2022-11-30 04:09:22,2022-11-30 11:01:57,Metal Cashback,0.01,0.00,GBP,COMPLETED,670004.08
CASHBACK,Savings,2022-11-30 17:51:44,2022-12-01 08:59:32,Metal Cashback,0.02,0.00,GBP,COMPLETED,670004.10
CASHBACK,Savings,2022-11-30 13:14:23,2022-12-01 09:22:00,Metal Cashback,0.01,0.00,GBP,COMPLETED,670004.11
CASHBACK,Savings,2022-11-30 22:12:43,2022-12-01 10:48:54,Metal Cashback,0.01,0.00,GBP,COMPLETED,670004.12
CASHBACK,Savings,2022-12-01 01:17:25,2022-12-01 13:01:47,Metal Cashback,0.01,0.00,GBP,COMPLETED,670004.13
CASHBACK,Savings,2022-12-01 13:10:57,2022-12-02 09:51:41,Metal Cashback,0.01,0.00,GBP,COMPLETED,670004.14
CASHBACK,Savings,2022-12-01 18:51:01,2022-12-02 16:35:08,Metal Cashback,0.02,0.00,GBP,COMPLETED,670004.16
CASHBACK,Savings,2022-12-02 14:19:56,2022-12-03 09:51:09,Metal Cashback,0.02,0.00,GBP,COMPLETED,670004.18
CASHBACK,Savings,2022-12-02 16:39:13,2022-12-03 10:54:14,Metal Cashback,0.10,0.00,GBP,COMPLETED,670004.28
CASHBACK,Savings,2022-12-03 01:18:01,2022-12-03 17:12:10,Metal Cashback,0.01,0.00,GBP,COMPLETED,670004.29
CASHBACK,Savings,2022-12-05 09:23:42,2022-12-06 08:48:27,Metal Cashback,0.05,0.00,GBP,COMPLETED,670004.34
CASHBACK,Savings,2022-12-05 22:45:13,2022-12-06 10:30:44,Metal Cashback,0.02,0.00,GBP,COMPLETED,670004.36
CASHBACK,Savings,2022-12-05 13:32:48,2022-12-06 10:46:01,Metal Cashback,0.02,0.00,GBP,COMPLETED,670004.38
CASHBACK,Savings,2022-12-06 13:15:26,2022-12-07 09:02:25,Metal Cashback,0.01,0.00,GBP,COMPLETED,670004.39
CASHBACK,Savings,2022-12-06 18:18:56,2022-12-07 09:09:09,Metal Cashback,0.04,0.00,GBP,COMPLETED,670004.43
CASHBACK,Savings,2022-12-06 10:22:56,2022-12-07 13:16:54,Metal Cashback,0.03,0.00,GBP,COMPLETED,670004.46
CASHBACK,Savings,2022-12-06 11:40:00,2022-12-07 13:17:36,Metal Cashback,0.02,0.00,GBP,COMPLETED,670004.48
CASHBACK,Savings,2022-12-08 15:09:27,2022-12-09 09:18:38,Metal Cashback,0.08,0.00,GBP,COMPLETED,670004.56
CASHBACK,Savings,2022-12-08 16:40:06,2022-12-09 10:31:23,Metal Cashback,0.06,0.00,GBP,COMPLETED,670004.62
CASHBACK,Savings,2022-12-08 10:55:55,2022-12-09 13:29:41,Metal Cashback,0.01,0.00,GBP,COMPLETED,670004.63
CASHBACK,Savings,2022-12-10 17:59:39,2022-12-11 11:26:36,Metal Cashback,0.04,0.00,GBP,COMPLETED,670004.67
CASHBACK,Savings,2022-12-10 13:10:14,2022-12-11 15:09:03,Metal Cashback,0.01,0.00,GBP,COMPLETED,670004.68
CASHBACK,Savings,2022-12-11 12:08:37,2022-12-12 13:23:34,Metal Cashback,0.01,0.00,GBP,COMPLETED,670004.69
TRANSFER,Savings,2022-12-12 14:50:06,2022-12-12 14:50:06,To GBP Home,360000.00,0.00,GBP,COMPLETED,1030004.69
CASHBACK,Savings,2022-12-12 10:15:42,2022-12-13 09:20:57,Metal Cashback,0.05,0.00,GBP,COMPLETED,1030004.74
CASHBACK,Savings,2022-12-13 12:08:53,2022-12-14 12:43:14,Metal Cashback,0.01,0.00,GBP,COMPLETED,1030004.75
CASHBACK,Savings,2022-12-14 17:29:45,2022-12-15 13:54:31,Metal Cashback,0.05,0.00,GBP,COMPLETED,1030004.80
CASHBACK,Savings,2022-12-15 18:35:59,2022-12-16 09:00:59,Metal Cashback,0.04,0.00,GBP,COMPLETED,1030004.84
CASHBACK,Savings,2022-12-15 22:57:10,2022-12-16 10:40:31,Metal Cashback,0.03,0.00,GBP,COMPLETED,1030004.87
CASHBACK,Savings,2022-12-16 17:37:53,2022-12-17 09:04:32,Metal Cashback,0.04,0.00,GBP,COMPLETED,1030004.91
CASHBACK,Savings,2022-12-17 18:42:59,2022-12-18 14:06:30,Metal Cashback,0.03,0.00,GBP,COMPLETED,1030004.94
CASHBACK,Savings,2022-12-18 23:11:07,2022-12-19 09:34:22,Metal Cashback,0.02,0.00,GBP,COMPLETED,1030004.96
CASHBACK,Savings,2022-12-18 16:25:44,2022-12-19 10:29:55,Metal Cashback,0.03,0.00,GBP,COMPLETED,1030004.99
CASHBACK,Savings,2022-12-19 08:00:34,2022-12-20 08:44:09,Metal Cashback,0.05,0.00,GBP,COMPLETED,1030005.04
CASHBACK,Savings,2022-12-20 10:59:14,2022-12-21 09:43:38,Metal Cashback,0.03,0.00,GBP,COMPLETED,1030005.07
CASHBACK,Savings,2022-12-22 03:17:50,2022-12-22 19:01:20,Metal Cashback,0.01,0.00,GBP,COMPLETED,1030005.08
CASHBACK,Savings,2022-12-20 17:22:58,2022-12-22 20:23:32,Metal Cashback,0.01,0.00,GBP,COMPLETED,1030005.09
CASHBACK,Savings,2022-12-21 10:11:50,2022-12-23 10:30:23,Metal Cashback,0.02,0.00,GBP,COMPLETED,1030005.11
CASHBACK,Savings,2022-12-23 01:10:43,2022-12-23 12:59:45,Metal Cashback,0.01,0.00,GBP,COMPLETED,1030005.12
CASHBACK,Savings,2022-12-23 16:16:08,2022-12-24 10:18:40,Metal Cashback,0.12,0.00,GBP,COMPLETED,1030005.24
CASHBACK,Savings,2022-12-23 09:39:37,2022-12-24 11:25:51,Metal Cashback,0.01,0.00,GBP,COMPLETED,1030005.25
CASHBACK,Savings,2022-12-23 10:58:43,2022-12-24 11:27:46,Metal Cashback,0.01,0.00,GBP,COMPLETED,1030005.26
CASHBACK,Savings,2022-12-23 16:21:35,2022-12-24 15:19:29,Metal Cashback,0.01,0.00,GBP,COMPLETED,1030005.27
CASHBACK,Savings,2022-12-23 12:44:31,2022-12-25 10:56:15,Metal Cashback,0.01,0.00,GBP,COMPLETED,1030005.28
CASHBACK,Savings,2022-12-25 01:01:44,2022-12-25 11:07:54,Metal Cashback,0.01,0.00,GBP,COMPLETED,1030005.29
CASHBACK,Savings,2022-12-24 22:43:19,2022-12-26 08:45:02,Metal Cashback,0.01,0.00,GBP,COMPLETED,1030005.30
CASHBACK,Savings,2022-12-26 15:23:33,2022-12-27 08:46:17,Metal Cashback,0.02,0.00,GBP,COMPLETED,1030005.32
CASHBACK,Savings,2022-12-26 15:03:05,2022-12-27 08:48:33,Metal Cashback,0.10,0.00,GBP,COMPLETED,1030005.42
CASHBACK,Savings,2022-12-26 18:37:06,2022-12-27 09:07:04,Metal Cashback,0.15,0.00,GBP,COMPLETED,1030005.57
CASHBACK,Savings,2022-12-26 21:06:31,2022-12-27 12:33:46,Metal Cashback,0.01,0.00,GBP,COMPLETED,1030005.58
TRANSFER,Savings,2022-12-29 06:52:21,2022-12-29 06:52:21,To GBP Home,20000.00,0.00,GBP,COMPLETED,1050005.58
CASHBACK,Savings,2022-12-28 19:21:05,2022-12-29 10:20:32,Metal Cashback,0.05,0.00,GBP,COMPLETED,1050005.63
CASHBACK,Savings,2022-12-29 13:13:07,2022-12-30 09:19:42,Metal Cashback,0.01,0.00,GBP,COMPLETED,1050005.64
CASHBACK,Savings,2022-12-29 13:46:37,2022-12-30 10:36:07,Metal Cashback,0.19,0.00,GBP,COMPLETED,1050005.83
CASHBACK,Savings,2022-12-30 05:19:05,2022-12-31 09:11:22,Metal Cashback,0.01,0.00,GBP,COMPLETED,1050005.84
CASHBACK,Savings,2022-12-30 16:45:35,2022-12-31 10:05:16,Metal Cashback,0.03,0.00,GBP,COMPLETED,1050005.87
CASHBACK,Savings,2023-01-02 18:57:40,2023-01-04 09:33:09,Metal Cashback,0.05,0.00,GBP,COMPLETED,1050005.92
CASHBACK,Savings,2023-01-04 22:52:41,2023-01-05 10:53:53,Metal Cashback,0.02,0.00,GBP,COMPLETED,1050005.94
TRANSFER,Savings,2023-01-05 21:03:21,2023-01-05 21:03:21,To GBP,-5.94,0.00,GBP,COMPLETED,1050000.00
CASHBACK,Savings,2023-01-04 14:22:17,2023-01-06 09:28:07,Metal Cashback,0.15,0.00,GBP,COMPLETED,1050000.15
CASHBACK,Savings,2023-01-06 11:41:44,2023-01-07 12:08:17,Metal Cashback,0.02,0.00,GBP,COMPLETED,1050000.17
CASHBACK,Savings,2023-01-11 12:11:01,2023-01-12 12:43:05,Metal Cashback,0.01,0.00,GBP,COMPLETED,1050000.18
CASHBACK,Savings,2023-01-13 01:13:56,2023-01-13 11:22:42,Metal Cashback,0.01,0.00,GBP,COMPLETED,1050000.19
CASHBACK,Savings,2023-01-13 12:10:02,2023-01-14 13:02:50,Metal Cashback,0.01,0.00,GBP,COMPLETED,1050000.20
CASHBACK,Savings,2023-01-14 01:11:59,2023-01-14 13:24:12,Metal Cashback,0.01,0.00,GBP,COMPLETED,1050000.21
CASHBACK,Savings,2023-01-14 23:01:28,2023-01-16 09:11:32,Metal Cashback,0.03,0.00,GBP,COMPLETED,1050000.24
CASHBACK,Savings,2023-01-17 23:02:36,2023-01-18 11:10:16,Metal Cashback,0.02,0.00,GBP,COMPLETED,1050000.26
CASHBACK,Savings,2023-01-18 23:11:21,2023-01-19 14:32:17,Metal Cashback,0.01,0.00,GBP,COMPLETED,1050000.27
CASHBACK,Savings,2023-01-22 03:17:06,2023-01-23 12:44:55,Metal Cashback,0.01,0.00,GBP,COMPLETED,1050000.28
CASHBACK,Savings,2023-01-30 04:53:28,2023-01-31 14:33:10,Metal Cashback,0.01,0.00,GBP,COMPLETED,1050000.29
CASHBACK,Savings,2023-01-29 13:10:07,2023-01-31 14:58:55,Metal Cashback,0.01,0.00,GBP,COMPLETED,1050000.30
CASHBACK,Savings,2023-01-29 22:33:03,2023-01-31 22:56:29,Metal Cashback,0.04,0.00,GBP,COMPLETED,1050000.34
CASHBACK,Savings,2023-02-02 16:44:26,2023-02-03 09:06:24,Metal Cashback,0.03,0.00,GBP,COMPLETED,1050000.37
CASHBACK,Savings,2023-02-03 12:37:35,2023-02-04 11:17:21,Metal Cashback,0.01,0.00,GBP,COMPLETED,1050000.38
CASHBACK,Savings,2023-02-03 22:48:04,2023-02-04 12:14:44,Metal Cashback,0.02,0.00,GBP,COMPLETED,1050000.40
CASHBACK,Savings,2023-02-06 11:40:19,2023-02-07 14:07:15,Metal Cashback,0.02,0.00,GBP,COMPLETED,1050000.42
CASHBACK,Savings,2023-02-10 12:47:46,2023-02-11 14:19:14,Metal Cashback,0.01,0.00,GBP,COMPLETED,1050000.43
CASHBACK,Savings,2023-02-11 03:24:59,2023-02-12 09:04:13,Metal Cashback,0.01,0.00,GBP,COMPLETED,1050000.44
CASHBACK,Savings,2023-02-11 12:09:45,2023-02-13 13:02:05,Metal Cashback,0.01,0.00,GBP,COMPLETED,1050000.45
CASHBACK,Savings,2023-02-13 23:06:10,2023-02-14 11:25:02,Metal Cashback,0.03,0.00,GBP,COMPLETED,1050000.48
CASHBACK,Savings,2023-02-13 12:09:32,2023-02-14 13:16:08,Metal Cashback,0.01,0.00,GBP,COMPLETED,1050000.49
CASHBACK,Savings,2023-02-22 03:21:41,2023-02-22 13:49:44,Metal Cashback,0.01,0.00,GBP,COMPLETED,1050000.50
CASHBACK,Savings,2023-02-23 00:50:48,2023-02-23 13:31:28,Metal Cashback,0.01,0.00,GBP,COMPLETED,1050000.51
CASHBACK,Savings,2023-02-23 00:50:00,2023-02-23 13:32:23,Metal Cashback,0.01,0.00,GBP,COMPLETED,1050000.52
CASHBACK,Savings,2023-02-23 01:11:02,2023-02-23 15:08:10,Metal Cashback,0.01,0.00,GBP,COMPLETED,1050000.53
CASHBACK,Savings,2023-02-24 01:14:58,2023-02-24 11:27:17,Metal Cashback,0.01,0.00,GBP,COMPLETED,1050000.54
CASHBACK,Savings,2023-02-26 01:12:51,2023-02-26 10:53:15,Metal Cashback,0.01,0.00,GBP,COMPLETED,1050000.55
CASHBACK,Savings,2023-02-27 01:02:10,2023-02-27 15:06:14,Metal Cashback,0.01,0.00,GBP,COMPLETED,1050000.56
CASHBACK,Savings,2023-02-28 05:11:15,2023-02-28 11:29:13,Metal Cashback,0.01,0.00,GBP,COMPLETED,1050000.57
CASHBACK,Savings,2023-02-28 17:31:17,2023-03-01 13:31:50,Metal Cashback,0.01,0.00,GBP,COMPLETED,1050000.58
CASHBACK,Savings,2023-03-03 01:10:59,2023-03-03 11:53:50,Metal Cashback,0.01,0.00,GBP,COMPLETED,1050000.59
CASHBACK,Savings,2023-03-05 22:53:41,2023-03-06 11:35:09,Metal Cashback,0.02,0.00,GBP,COMPLETED,1050000.61
CASHBACK,Savings,2023-03-06 11:43:53,2023-03-07 13:36:30,Metal Cashback,0.02,0.00,GBP,COMPLETED,1050000.63
CASHBACK,Savings,2023-03-10 13:38:59,2023-03-11 14:40:01,Metal Cashback,0.02,0.00,GBP,COMPLETED,1050000.65
CASHBACK,Savings,2023-03-11 12:09:08,2023-03-12 13:02:49,Metal Cashback,0.01,0.00,GBP,COMPLETED,1050000.66
CASHBACK,Savings,2023-03-13 11:06:13,2023-03-14 14:55:02,Metal Cashback,0.01,0.00,GBP,COMPLETED,1050000.67
CASHBACK,Savings,2023-03-16 01:06:32,2023-03-16 16:27:29,Metal Cashback,0.01,0.00,GBP,COMPLETED,1050000.68
CASHBACK,Savings,2023-03-15 23:03:16,2023-03-16 17:02:41,Metal Cashback,0.03,0.00,GBP,COMPLETED,1050000.71
CASHBACK,Savings,2023-03-18 01:09:58,2023-03-20 17:11:22,Metal Cashback,0.01,0.00,GBP,COMPLETED,1050000.72
CASHBACK,Savings,2023-03-22 02:17:36,2023-03-22 12:23:24,Metal Cashback,0.01,0.00,GBP,COMPLETED,1050000.73
CASHBACK,Savings,2023-03-23 10:31:38,2023-03-24 10:09:48,Metal Cashback,0.01,0.00,GBP,COMPLETED,1050000.74
CASHBACK,Savings,2023-03-25 01:11:19,2023-03-25 13:08:33,Metal Cashback,0.01,0.00,GBP,COMPLETED,1050000.75
CASHBACK,Savings,2023-03-22 10:53:10,2023-03-28 09:04:06,Metal Cashback,0.11,0.00,GBP,COMPLETED,1050000.86
CASHBACK,Savings,2023-03-27 08:48:17,2023-03-28 10:53:55,Metal Cashback,0.10,0.00,GBP,COMPLETED,1050000.96
CASHBACK,Savings,2023-03-28 09:23:13,2023-03-29 09:49:42,Metal Cashback,0.05,0.00,GBP,COMPLETED,1050001.01
CASHBACK,Savings,2023-03-29 13:51:40,2023-03-30 09:43:09,Metal Cashback,0.01,0.00,GBP,COMPLETED,1050001.02
CASHBACK,Savings,2023-03-30 04:29:40,2023-03-30 11:26:33,Metal Cashback,0.01,0.00,GBP,COMPLETED,1050001.03
CASHBACK,Savings,2023-03-30 01:11:58,2023-03-30 11:34:10,Metal Cashback,0.01,0.00,GBP,COMPLETED,1050001.04
TRANSFER,Savings,2023-04-05 08:22:44,2023-04-05 08:22:44,To GBP,-1.04,0.00,GBP,COMPLETED,1050000.00
CASHBACK,Savings,2023-04-04 22:50:42,2023-04-05 11:41:33,Metal Cashback,0.02,0.00,GBP,COMPLETED,1050000.02
